a	.ar	.elem	後接母音開頭之字時為 an
A.M.	.av	.elem	= a.m.= AM
abandon	.vb/.nn	.int	
abandoned	.aj	.hi	
abbey	.nn	.hi	
abbreviate	.vb	.hi	
abbreviation	.nn	.hi	
abdomen	.nn	.hi	
abide	.vb	.hi	
ability	.nn	.elem	
able	.aj	.elem	
abnormal	.aj	.int	
aboard	.pr/.av	.int	
abolish	.vb	.hi	
aboriginal	.aj/.nn	.hi	
aborigine	.nn	.hi	
abortion	.nn	.hi	
abound	.vb	.hi	
about	.pr/.av	.elem	
above	.pr/.av/.aj	.elem	
abroad	.av	.elem	
abrupt	.aj	.hi	
absence	.nn	.int	
absent	.aj	.elem	
absent-minded	.aj	.hi	
absolute	.aj/.nn	.int	
absolutely	.av	.int	
absorb	.vb	.int	
abstract	.aj/.nn	.int	抽象的，摘要
abstraction	.nn	.hi	
absurd	.aj/.nn	.hi	
abundance	.nn	.hi	
abundant	.aj	.hi	
abuse	.nn/.vb	.int	
academic	.aj	.int	
academy	.nn	.int	
accelerate	.vb	.hi	
acceleration	.nn	.hi	
accent	.nn	.int	
accept	.vb	.elem	
acceptable	.aj	.int	
acceptance	.nn	.int	
accepted	.aj	.int	
access	.nn/.vb	.int	
accessible	.aj	.hi	
accessory	.nn/.aj	.hi	
accident	.nn	.elem	
accidental	.aj	.int	
acclaim	.vb/.nn	.hi	
accommodate	.vb	.int	
accommodation	.nn	.int	
accompany	.vb	.int	
accomplish	.vb	.int	
accomplished	.aj	.hi	
accord	.vb/.nn	.int	
accordance	.nn	.hi	
accordingly	.av	.hi	
account	.nn/.vb	.int	
accountable	.aj	.hi	
accountant	.nn	.int	
accounting	.nn	.hi	
accumulate	.vb	.hi	
accumulation	.nn	.hi	
accuracy	.nn	.int	
accurate	.aj	.int	
accusation	.nn	.hi	
accuse	.vb	.int	
accustom	.vb	.hi	
accustomed	.aj	.int	
ace	.nn/.aj/.vb	.hi	
ache	.nn/.vb	.int	
achieve	.vb	.elem	
achievement	.nn	.int	
acid	.nn/.aj	.int	
acknowledge	.vb	.hi	
acne	.nn	.hi	
acoustic	.aj/.nn	.hi	
acquaint	.vb	.int	
acquaintance	.nn	.int	
acquire	.vb	.int	
acquisition	.nn	.hi	
acre	.nn	.int	
across	.pr/.av	.elem	
act	.nn/.vb	.elem	
acting	.nn/.aj	.hi	
action	.nn	.elem	
activate	.vb	.hi	
active	.aj	.elem	
activist	.nn	.hi	
activity	.nn	.elem	
actor	.nn	.elem	
actress	.nn	.elem	
actual	.aj	.int	
actually	.av	.elem	
acute	.aj/.nn	.hi	
ad	.nn	.hi	= advertisement
adapt	.vb	.int	
adaptation	.nn	.hi	
add	.vb	.elem	
addict	.nn	.hi	
addicted	.aj	.hi	
addiction	.nn	.hi	
addition	.nn	.elem	
additional	.aj	.int	
additive	.nn/.aj	.hi	
address	.nn	.elem	
adequate	.aj	.int	
adhere	.vb	.hi	
.ajacent	.aj	.hi	
.ajective	.nn	.int	= adj.
.ajoin	.vb	.hi	
.ajust	.vb	.int	
.ajustment	.nn	.hi	
administer	.vb	.hi	
administration	.nn	.int	
administrative	.aj	.hi	
administrator	.nn	.hi	
admirable	.aj	.int	
admiral	.nn	.hi	
admiration	.nn	.int	
admire	.vb	.elem	
admission	.nn	.int	
admit	.vb	.elem	
adolescence	.nn	.hi	
adolescent	.aj/.nn	.hi	
adopt	.vb	.elem	
adore	.vb	.hi	
adult	.nn	.elem	
adulthood	.nn	.hi	
advance	.nn/.vb	.elem	
advanced	.aj	.int	
advancement	.nn	.hi	
advantage	.nn	.elem	
advent	.nn	.hi	
adventure	.nn	.int	
ad.vb	.nn	.hi	
adverse	.aj	.hi	
advert	.nn	.hi	= ad, advertisement
advertise	.vb	.int	= advertize
advertisement	.nn	.elem	
advertiser	.nn	.hi	
advertising	.nn	.hi	
advice	.nn	.elem	
advisable	.aj	.hi	
advise	.vb	.elem	
adviser	.nn	.int	= advisor
advisory	.aj/.nn	.hi	
advocate	.vb/.nn	.hi	
aerial	.aj/.nn	.hi	noun = antenna (American English)
aerospace	.nn	.hi	
aesthetic	.aj	.hi	= esthetic
aesthetics	.nn	.hi	= esthetics
affair	.nn	.elem	
affect	.vb	.elem	
affection	.nn	.int	
affectionate	.aj	.hi	
affiliate	.nn/.vb	.hi	
affirm	.vb	.hi	
afflict	.vb	.hi	
afford	.vb	.int	
afraid	.aj	.elem	
after	.pr/.cj	.elem	
aftermath	.nn	.hi	
afternoon	.nn	.elem	
afterwards	.av	.int	
again	.av	.elem	
against	.pr	.elem	
age	.nn/.vb	.elem	
aged	.aj	.int	
agency	.nn	.int	
agenda	.nn	.hi	
agent	.nn	.int	
aggravate	.vb	.hi	
aggregate	.aj/.nn/.vb	.hi	
aggression	.nn	.hi	
aggressive	.aj	.int	
aging	.aj/.nn	.hi	= ageing
agitate	.vb	.hi	
agitation	.nn	.hi	
ago	.av	.elem	
agony	.nn	.hi	
agree	.vb	.elem	
agreeable	.aj	.int	
agreement	.nn	.int	
agricultural	.aj	.hi	
agriculture	.nn	.int	
ahead	.av	.elem	
AI	.nn	.hi	= artificial intelligence
aid	.nn/.vb	.elem	
aide	.nn	.hi	
AIDS	.nn	.elem	
aim	.vb/.nn	.elem	
air	.nn	.elem	
air-conditioned	.aj	.int	
air-conditioner	.nn	.hi	= air conditioner
aircraft	.nn	.elem	
airlift	.nn/.vb	.hi	
airline	.nn	.elem	
airmail	.nn	.int	
airplane	.nn	.elem	= plane, aeroplane (British English)
airport	.nn	.elem	
airtight	.aj	.hi	
airway	.nn	.hi	
aisle	.nn	.hi	
alarm	.nn	.elem	
alarming	.aj	.hi	
album	.nn	.elem	
alcohol	.nn	.int	
alcoholic	.nn/.aj	.int	
alert	.vb/.aj/.nn	.int	
algebra	.nn	.hi	
alien	.aj/.nn	.hi	
alienate	.vb	.hi	
alike	.av/.aj	.elem	
alive	.aj	.elem	
all	.aj/.pn/.av	.elem	
allegation	.nn	.hi	
allege	.vb	.hi	
alleged	.aj	.hi	
allergic	.aj	.hi	
allergy	.nn	.hi	
alleviate	.vb	.hi	
alley	.nn	.int	
alliance	.nn	.hi	
allied	.aj	.hi	
alligator	.nn	.hi	
allocate	.vb	.hi	
allow	.vb	.elem	
allowance	.nn	.int	= pocket money
alloy	.nn	.hi	
ally	.nn/.vb	.hi	
almond	.nn	.hi	
almost	.av	.elem	
alone	.av/.aj	.elem	
along	.pr/.av	.elem	
alongside	.pr/.av	.int	
aloud	.av	.elem	
alphabet	.nn	.elem	
already	.av	.elem	
also	.av	.elem	
alter	.vb	.hi	
alternate	.vb/.aj	.hi	
alternative	.nn/.aj	.int	
alternatively	.av	.hi	
although	.cj	.elem	
altitude	.nn	.int	
altogether	.av	.elem	
aluminium	.nn/.aj	.int	
always	.av	.elem	
am	.vb	.elem	
amateur	.aj/.nn	.int	
amaze	.vb	.int	
amazing	.aj	.int	
ambassador	.nn	.int	
ambiguity	.nn	.hi	
ambiguous	.aj	.hi	
ambition	.nn	.int	
ambitious	.aj	.int	
ambulance	.nn	.elem	
ambush	.vb/.nn	.hi	
amend	.vb	.hi	
amendment	.nn	.hi	
amends	.nn	.hi	賠償
America	.nn	.elem	
American	.aj/.nn	.elem	
amiable	.aj	.hi	
amicable	.aj	.hi	
amid	.pr	.int	
ammunition	.nn	.hi	
amnesty	.nn	.hi	
among	.pr	.elem	
amount	.nn	.elem	
ample	.aj	.hi	
amplify	.vb	.hi	
amuse	.vb	.int	
amused	.aj	.int	
amusement	.nn	.int	
amusing	.aj	.int	
amzed	.aj	.int	
analogy	.nn	.hi	
analysis	.nn	.int	
analyst	.nn	.int	
analytical	.aj	.hi	= analytic
analyze	.vb	.int	= analyse (British English)
ancestor	.nn	.int	
anchor	.nn/.vb	.hi	
ancient	.aj	.elem	
and	.cj	.elem	
anecdote	.nn	.hi	
angel	.nn	.elem	
anger	.nn	.elem	
angle	.nn	.int	
angler	.nn	.hi	
angry	.aj	.elem	
animal	.nn	.elem	
animate	.aj/.vb	.hi	
animated	.aj	.hi	
ankle	.nn	.elem	
anniversary	.nn	.int	
an.nnce	.vb	.int	
an.nncement	.nn	.int	
an.nncer	.nn	.int	
annoy	.vb	.int	
annoyance	.nn	.hi	
annoyed	.aj	.int	
annoying	.aj	.int	
annual	.aj/.nn	.int	
anonymous	.aj	.hi	
another	.pn/.aj	.elem	
answer	.nn/.vb	.elem	
ant	.nn	.elem	
Antarctic	.aj/.nn	.hi	= antarctic, 南極
antenna	.nn	.hi	
anthem	.nn	.hi	
antibiotic	.nn/.aj	.hi	
antibody	.nn	.hi	
anticipate	.vb	.hi	
anticipation	.nn	.hi	
antique	.nn/.aj	.hi	
antonym	.nn	.hi	
anxiety	.nn	.int	
anxious	.aj	.int	
any	.pn/.av/.aj	.elem	
anybody	.pn	.elem	= anyone
anyhow	.av	.int	
anymore	.av	.hi	
anyone	.pn	.elem	= anybody
anything	.pn	.elem	
anytime	.av	.int	
anyway	.av	.elem	
anywhere	.av	.elem	= anyplace
ap.ar	.av/.aj	.int	
ap.arheid	.nn	.hi	
ap.arment	.nn	.elem	= flat (British English)
ape	.nn/.vb	.int	
apologize	.vb	.elem	= apoligise (British English)
apology	.nn	.int	
appall	.vb	.hi	= appal (British English)
appalling	.aj	.hi	
apparatus	.nn	.hi	
apparent	.aj	.int	
apparently	.av	.int	
appeal	.nn/.vb	.int	
appear	.vb	.elem	
appearance	.nn	.elem	
appendix	.nn	.hi	
appetite	.nn	.int	
applaud	.vb	.int	
applause	.nn	.int	
apple	.nn	.elem	
appliance	.nn	.int	
applicable	.aj	.hi	
applicant	.nn	.int	
application	.nn	.int	
apply	.vb	.elem	
appoint	.vb	.int	
appointment	.nn	.int	
appraisal	.nn	.hi	
appreciable	.aj	.hi	
appreciate	.vb	.elem	
appreciation	.nn	.int	
apprehension	.nn	.hi	
apprentice	.nn/.vb	.hi	
approach	.nn/.vb	.int	
appropriate	.aj	.int	
approval	.nn	.int	
approve	.vb	.int	
approximate	.aj/.vb	.hi	
April	.nn	.elem	= Apr.
apron	.nn	.int	
apt	.aj	.hi	
aptitude	.nn	.hi	
aquarium	.nn	.int	
arbitrary	.aj	.hi	
arc	.nn/.vb	.hi	
arch	.nn/.vb	.int	
archaeology	.nn	.hi	= archeology
architect	.nn	.int	
architectural	.aj	.hi	
architecture	.nn	.int	
archive	.nn/.aj	.hi	
Arctic	.aj/.nn	.hi	= arctic, 北極
are	.vb	.elem	
area	.nn	.elem	
arena	.nn	.hi	
argue	.vb	.elem	
argument	.nn	.int	
arise	.vb	.int	
arithmetic	.nn/.aj	.int	
arm	.nn	.elem	
armchair	.nn	.elem	
armed	.aj	.int	
armor	.nn/.vb	.hi	= armour (British English)
armored	.aj	.hi	= armoured (British English)
arms	.nn	.hi	
army	.nn	.elem	
around	.pr/.av	.elem	
arouse	.vb	.int	
arrange	.vb	.elem	
arrangement	.nn	.int	
array	.nn/.vb	.hi	
arrest	.vb/.nn	.elem	
arrival	.nn	.int	
arrive	.vb	.elem	
arrogant	.aj	.hi	
arrow	.nn	.int	
.ar	.nn	.elem	
.arery	.nn	.hi	
.aricle	.nn	.elem	
.ariculate	.aj/.vb	.hi	
.arifact	.nn	.hi	
.arificial	.aj	.int	
.arillery	.nn	.hi	
.arist	.nn	.elem	
.aristic	.aj	.int	
as	.cj/.pr/.av	.elem	
ascend	.vb	.int	
ascending	.aj	.int	
ascertain	.vb	.hi	
ascribe	.vb	.hi	
ash	.nn	.int	
ashamed	.aj	.int	
Asia	.nn	.elem	
Asian	.aj/.nn	.elem	
aside	.av	.int	
ask	.vb	.elem	
asleep	.aj	.elem	
aspect	.nn	.int	
aspiration	.nn	.hi	
aspirin	.nn	.int	
ass	.nn	.hi	
assassinate	.vb	.int	
assault	.nn/.aj/.vb	.hi	
assemble	.vb	.int	
assembly	.nn	.int	
assert	.vb	.hi	
assess	.vb	.hi	
assessment	.nn	.hi	
asset	.nn	.int	
assign	.vb	.int	
assignment	.nn	.hi	
assimilate	.vb	.hi	
assist	.vb	.int	
assistance	.nn	.int	
assistant	.nn/.aj	.elem	
associate	.vb/.nn	.int	
associated	.aj	.hi	
association	.nn	.int	
assume	.vb	.elem	
assuming	.cj/.aj	.hi	adj. 傲慢的
assumption	.nn	.hi	
assurance	.nn	.int	
assure	.vb	.int	
assured	.aj	.hi	
asthma	.nn	.hi	
astonish	.vb	.int	
astonished	.aj	.int	
astonishing	.aj	.int	
astray	.av/.aj	.hi	
astronaut	.nn	.int	
astronomer	.nn	.hi	
astronomy	.nn	.hi	
asylum	.nn	.hi	
at	.pr	.elem	
athlete	.nn	.int	
athletic	.aj	.int	
athletics	.nn	.hi	
ATM	.nn	.hi	= automatic teller machine
atmosphere	.nn	.int	
atom	.nn	.int	
atomic	.aj	.int	
atrocity	.nn	.hi	
attach	.vb	.int	
attached	.aj	.hi	
attack	.nn/.vb	.elem	
attain	.vb	.hi	
attempt	.nn/.vb	.int	
attempted	.aj	.hi	
attend	.vb	.elem	
attendance	.nn	.hi	
attendant	.nn/.aj	.hi	
attention	.nn	.elem	
attic	.nn	.hi	
attitude	.nn	.int	
attorney	.nn	.hi	
attract	.vb	.int	
attraction	.nn	.int	
attractive	.aj	.int	
attribute	.vb/.nn	.hi	
auction	.nn/.vb	.hi	
audience	.nn	.elem	
audio	.aj	.int	
audit	.vb/.nn	.hi	
auditorium	.nn	.hi	
August	.nn	.elem	= Aug.
aunt	.nn	.elem	= auntie= aunty
Australia	.nn	.elem	
Australian	.aj/.nn	.elem	
authentic	.aj	.hi	
author	.nn	.int	
authoritative	.aj	.hi	
authority	.nn	.int	
authorize	.vb	.hi	= authorise (British English)
auto	.nn	.hi	
autobiography	.nn	.int	
autograph	.nn/.vb	.hi	
automatic	.aj	.int	
automation	.nn	.hi	
automobile	.nn	.int	= auto
autonomous	.aj	.hi	
autonomy	.nn	.hi	
autumn	.nn	.elem	= fall
auxiliary	.nn/.aj	.int	= aux.
avail	.vb/.nn	.hi	
available	.aj	.elem	
avenue	.nn	.int	
average	.aj/.nn/.vb	.int	
avert	.vb	.hi	
aviary	.nn	.hi	
aviation	.nn	.hi	
avoid	.vb	.elem	
await	.vb	.int	
awake	.aj/.vb	.int	
awaken	.vb	.int	
award	.nn/.vb	.int	
aware	.aj	.elem	
away	.av	.elem	
awe	.nn/.vb	.hi	
awesome	.aj	.hi	
awful	.aj	.int	
awhile	.av	.hi	
awkward	.aj	.int	
ax	.nn/.vb	.int	= axe (British English)
axis	.nn	.hi	
B. S.		.hi	= British Standard; Bachelor of Science
B. C.		.int	= Before Christ
baby	.nn	.elem	
babysit	.vb	.int	= baby-sit
babysitter	.nn	.int	= baby-sitter
bachelor	.nn	.hi	
back	.av/.nn/.vb/.aj	.elem	
backbone	.nn	.hi	
background	.nn	.int	
backing	.nn	.hi	
backpack	.nn/.vb	.hi	
backward	.av/.aj	.elem	adv.= backwards (British English)
bacon	.nn	.int	
bacteria	.nn	.int	bacterium (singular form)
bad	.aj	.elem	
badge	.nn	.hi	
badly	.av	.int	
badminton	.nn	.elem	
baffle	.vb/.nn	.hi	
bag	.nn	.elem	
baggage	.nn	.int	
baggy	.aj	.int	
bail	.nn/.vb	.hi	
bait	.nn/.vb	.int	
bake	.vb	.elem	
bakery	.nn	.elem	
balance	.nn/.vb	.int	
balanced	.aj	.hi	
balcony	.nn	.elem	
bald	.aj	.int	
ball	.nn	.elem	
ballet	.nn	.int	
balloon	.nn	.elem	
ballot	.nn/.vb	.hi	
bamboo	.nn	.int	
ban	.vb/.nn	.int	
banana	.nn	.elem	
band	.nn	.elem	
bandage	.nn/.vb	.int	
band-aid	.nn/.aj	.int	
bandit	.nn	.hi	
bang	.nn/.vb	.int	
bank	.nn	.elem	銀行,岸
banker	.nn	.elem	
banking	.nn	.hi	
bankrupt	.aj/.vb/.nn	.int	
bankruptcy	.nn	.hi	
banner	.nn	.hi	
banquet	.nn/.vb	.hi	
bar	.nn	.elem	
barbarian	.nn/.aj	.hi	
barbecue	.nn/.vb	.elem	= Bar-B-Q
barber	.nn	.elem	
barbershop	.nn	.hi	
bare	.aj/.vb	.int	
barefoot	.aj/.av	.hi	
barely	.av	.int	
bargain	.nn/.vb	.int	
barge	.nn	.hi	
barge	.vb	.hi	
bark	.vb/.nn	.elem	
barn	.nn	.int	
barometer	.nn	.hi	
barrack	.nn/.vb	.hi	
barrel	.nn	.int	
barren	.aj/.nn	.hi	
barricade	.nn/.vb	.hi	
barrier	.nn	.int	
base	.vb/.nn	.elem	
baseball	.nn	.elem	
based	.aj	.int	
basement	.nn	.elem	
bash	.nn/.vb	.hi	
basic	.aj	.elem	
basically	.av	.hi	
basics	.nn	.hi	
basin	.nn	.int	
basis	.nn	.elem	
basket	.nn	.elem	
basketball	.nn	.elem	
bass	.nn/.aj	.hi	
bastard	.nn/.aj	.hi	
bat	.nn	.elem	
batch	.nn	.hi	
bath	.nn	.elem	
bathe	.vb	.int	
bathroom	.nn	.elem	
battalion	.nn	.hi	
batter	.vb	.hi	
battery	.nn	.int	
battle	.nn/.vb	.int	
battlefield	.nn	.hi	
bay	.nn	.int	
bazaar	.nn	.hi	
be	.vb	.elem	
beach	.nn	.elem	
bead	.nn/.vb	.int	
beak	.nn	.int	
beam	.nn/.vb	.int	
bean	.nn	.elem	
bear	.nn	.elem	熊
bear	.vb	.elem	生產,承受
beard	.nn	.elem	
bearing	.nn	.hi	
beast	.nn	.int	
beat	.vb/.nn	.elem	
beaten	.aj	.hi	
beating	.nn	.hi	
beautiful	.aj	.elem	
beautify	.vb	.hi	
beauty	.nn	.int	
because	.cj	.elem	= 'cos
beckon	.vb	.hi	
become	.vb	.elem	
bed	.nn	.elem	
bedroom	.nn	.elem	
bedtime	.nn/.aj	.int	
bee	.nn	.elem	
beef	.nn	.elem	
beep	.nn/.vb	.hi	
beer	.nn	.elem	
beetle	.nn	.int	
before	.pr/.cj/.av	.elem	
beforehand	.av	.hi	
beg	.vb	.int	
beggar	.nn/.vb	.int	
begin	.vb	.elem	
beginner	.nn	.elem	
beginning	.nn/.aj	.elem	
behalf	.nn	.hi	
behave	.vb	.elem	
behavior	.nn	.int	= behaviour (British English)
behind	.pr/.av	.elem	
being	.nn	.int	物，生物
belief	.nn	.elem	
believable	.aj	.int	
believe	.vb	.elem	
bell	.nn	.elem	
belly	.nn	.int	
belong	.vb	.elem	
belongings	.nn	.hi	
beloved	.aj/.nn	.hi	
below	.av/.pr	.elem	
belt	.nn	.elem	
bench	.nn	.elem	
bend	.vb/.nn	.int	
beneath	.pr	.int	
beneficial	.aj	.int	
benefit	.nn/.vb	.int	
bent	.aj/.nn	.hi	
berry	.nn	.int	
beside	.pr	.elem	
besides	.pr/.av	.elem	= beside(prep.)
besiege	.vb	.hi	
best	.av/.aj	.elem	
bet	.nn/.vb	.int	
betray	.vb	.hi	
better	.av/.aj	.elem	
between	.pr	.elem	
beverage	.nn	.hi	
beware	.vb	.hi	
bewilder	.vb	.hi	
beyond	.pr/.av	.elem	
bias	.nn/.vb	.hi	
Bible	.nn	.int	
bibliography	.nn	.hi	
bicycle	.nn	.elem	= bike
bid	.nn/.vb	.int	
big	.aj	.elem	
bike	.nn	.int	
bilateral	.aj	.hi	
bill	.nn	.elem	
billion	.nn	.int	
bin	.nn	.int	
bind	.vb	.int	
binding	.aj/.nn	.hi	
bingo	.nn	.int	
binoculars	.nn	.hi	
biochemistry	.nn	.hi	
biography	.nn	.int	
biological	.aj	.hi	
biology	.nn	.elem	
bird	.nn	.elem	
birdie	.nn/.vb	.hi	
birth	.nn	.int	
birthday	.nn	.elem	
biscuit	.nn	.int	
bit	.nn	.elem	
bitch	.nn/.vb	.hi	
bite	.vb/.nn	.elem	
bitter	.aj	.elem	
bizarre	.aj	.hi	
black	.aj/.nn	.elem	
blackboard	.nn	.elem	
blacksmith	.nn	.hi	
blade	.nn	.hi	
blame	.vb/.nn	.elem	
bland	.aj	.hi	
blank	.aj/.nn	.elem	
blanket	.nn	.elem	
blare	.vb/.nn	.hi	
blast	.nn/.vb	.hi	
blaze	.vb/.nn	.hi	
bleach	.vb/.nn	.hi	
bleak	.aj	.hi	
bleed	.vb	.int	
blend	.vb	.int	
bless	.vb/.nn	.int	
blessing	.nn	.int	
blind	.aj	.elem	
blink	.vb/.nn	.int	
blizzard	.nn	.hi	
bloc	.nn	.hi	
block	.nn/.vb	.elem	
blockade	.nn/.vb	.hi	
blonde	.aj/.nn	.hi	女性為blonde，男性為 blond
blood	.nn	.elem	
bloody	.aj	.int	
bloom	.nn/.vb	.int	
blossom	.nn/.vb	.int	
blot	.nn/.vb	.hi	
blouse	.nn	.elem	
blow	.vb/.nn	.elem	
blue	.aj/.nn	.elem	
blues	.nn	.hi	
blunder	.nn/.vb	.hi	
blunt	.aj/.vb	.hi	
blur	.nn/.vb	.hi	
blush	.vb/.nn	.int	
board	.vb	.elem	乘坐某種交通工具
board	.nn	.elem	木板
boast	.vb/.nn	.int	
boat	.nn	.elem	
bob	.vb/.nn	.hi	晃動；束髮
bodily	.aj/.av	.hi	
body	.nn	.elem	
bodyguard	.nn	.hi	
bog	.nn	.hi	
boil	.vb	.elem	
boiling	.aj	.hi	
bold	.aj	.int	
bolster	.vb/.nn	.hi	
bolt	.nn/.vb	.hi	
bomb	.nn	.elem	
bombard	.vb	.hi	
bomber	.nn	.hi	
bond	.nn/.vb	.int	
bondage	.nn	.hi	
bone	.nn	.elem	
bonus	.nn	.hi	
bony	.aj	.int	
book	.nn	.elem	書本
book	.vb	.elem	預訂
bookcase	.nn	.elem	
booking	.nn	.hi	
booklet	.nn	.int	
bookshelf	.nn	.int	
bookstore	.nn	.int	= bookshop (British English)
boom	.nn/.vb	.hi	
boost	.vb/.nn	.hi	
boot	.nn/.vb	.int	
booth	.nn	.hi	
border	.nn/.vb	.int	
bore	.vb/.nn	.int	
bored	.aj	.elem	
boredom	.nn	.hi	
boring	.aj	.elem	
born	.aj	.elem	
borough	.nn	.hi	
borrow	.vb	.elem	
borrowing	.nn	.hi	
bosom	.nn	.hi	
boss	.nn	.elem	
botanical	.aj	.hi	= botanic
botany	.nn	.hi	
both	.av/.aj/.pn	.elem	
bother	.vb/.nn	.elem	
bottle	.nn	.elem	
bottom	.nn/.aj	.elem	
boulevard	.nn	.hi	
bounce	.vb/.nn	.int	
bound	.aj/.nn	.hi	
boundary	.nn	.hi	
bout	.nn	.hi	
bow	.nn	.int	船首 (P)
bow	.vb/.nn	.elem	鞠躬,點頭致意(P)
bowel	.nn	.hi	
bowl	.nn	.elem	
bowler	.nn	.hi	
bowling	.nn	.elem	
box	.nn	.elem	
boxer	.nn	.hi	
boxing	.nn	.hi	
boy	.nn	.elem	
boycott	.vb/.nn	.int	
boyfriend	.nn	.int	
boyhood	.nn	.hi	
bra	.nn	.int	= brassiere
brace	.vb/.nn	.hi	
bracelet	.nn	.int	
bracket	.nn/.vb	.hi	
braid	.nn/.vb	.hi	
brain	.nn	.elem	
brake	.nn/.vb	.int	
branch	.nn	.elem	
brand	.nn/.vb	.int	
brand-new	.aj	.hi	
brass	.nn/.aj	.int	
brassiere	.nn	.hi	= bra
brave	.aj	.elem	
bravery	.nn	.int	
breach	.vb/.nn	.hi	
bread	.nn	.elem	
breadth	.nn	.hi	
break	.vb/.nn	.elem	
breakdown	.nn	.hi	
breakfast	.nn	.elem	
break-in	.nn	.hi	
breakthrough	.nn	.hi	
break-up	.nn	.hi	
breast	.nn/.vb	.int	
breath	.nn	.int	
breathe	.vb	.int	
breed	.nn/.vb	.int	
breeder	.nn	.hi	
breeze	.nn/.vb	.int	
brew	.vb/.nn	.hi	
bribe	.nn/.vb	.int	
brick	.nn	.elem	
bride	.nn	.int	
bridegroom	.nn	.int	= groom
bridge	.nn	.elem	
brief	.aj	.elem	
briefcase	.nn	.int	
briefing	.nn	.hi	
briefly	.av	.hi	
brigade	.nn	.hi	
bright	.aj	.elem	
brilliant	.aj	.int	
bring	.vb	.elem	
brink	.nn	.hi	
brisk	.aj	.hi	
Britain	.nn	.elem	
British	.aj/.nn	.elem	
brittle	.aj	.hi	
broad	.aj	.elem	
broadcast	.nn/.vb	.elem	
broadcaster	.nn	.hi	
broadcasting	.nn	.hi	
broaden	.vb	.hi	
broadly	.av	.hi	
brochure	.nn	.hi	
broil	.vb	.hi	= grill
broke	.aj	.int	
broker	.nn/.vb	.hi	
bronze	.nn	.hi	
brooch	.nn	.hi	
brood	.nn/.vb	.hi	
brook	.nn	.int	
broom	.nn	.int	
broth	.nn	.hi	
brother	.nn	.elem	
brotherhood	.nn	.hi	
brow	.nn	.hi	
brown	.aj/.nn	.elem	
brownie	.nn	.int	
browse	.vb/.nn	.int	
bruise	.nn/.vb	.hi	
brunch	.nn	.elem	
brush	.nn/.vb	.elem	
brutal	.aj	.int	
brute	.nn/.aj	.hi	
bubble	.nn/.vb	.int	
buck	.nn	.hi	
buck	.vb/.aj	.hi	
bucket	.nn	.elem	= pail
buckle	.nn/.vb	.hi	
bud	.nn/.vb	.int	
budget	.nn/.vb	.int	
buffalo	.nn	.int	
buffer	.nn/.vb	.hi	
buffet	.nn	.elem	
bug	.nn	.elem	
build	.vb	.elem	
building	.nn	.elem	
build-up	.nn	.hi	= buildup, build up
bulb	.nn	.int	
bulge	.nn/.vb	.hi	
bulk	.nn/.vb	.hi	
bulky	.aj	.hi	
bull	.nn	.int	
bullet	.nn	.int	
bulletin	.nn	.int	
bully	.nn/.vb	.hi	
bump	.vb/.nn	.int	
bun	.nn	.elem	
bunch	.nn	.int	
bundle	.nn	.elem	
bunker	.nn/.vb	.hi	
burden	.nn/.vb	.int	
bureau	.nn	.int	
bureaucracy	.nn	.hi	
bureaucrat	.nn	.hi	
bureaucratic	.aj	.hi	
burger	.nn	.int	
burglar	.nn	.int	
burial	.nn	.hi	
burn	.vb	.elem	
burning	.aj	.hi	
burst	.vb	.elem	
bury	.vb	.int	
bus	.nn	.elem	
bush	.nn	.int	
business	.nn	.elem	
businessman	.nn	.elem	
bust	.nn	.hi	半身像
bust	.vb/.aj	.hi	突擊
busy	.aj	.elem	
but	.cj/.pr	.elem	
butcher	.nn/.vb	.int	
butter	.nn	.elem	
butterfly	.nn	.elem	
button	.nn/.vb	.elem	
buy	.vb	.elem	
buzz	.vb/.nn	.int	
by	.pr/.av	.elem	
bypass	.vb/.nn	.hi	
byte	.nn	.hi	
cabbage	.nn	.elem	
cabin	.nn	.int	
cabinet	.nn	.elem	
cable	.nn	.elem	
cactus	.nn	.hi	
cafe	.nn	.int	= café
cafeteria	.nn	.elem	
caffeine	.nn	.hi	
cage	.nn	.elem	
cake	.nn	.elem	
calcium	.nn	.hi	
calculate	.vb	.int	
calculated	.aj	.hi	
calculating	.aj	.int	
calculator	.nn	.int	
calendar	.nn	.elem	
calf	.nn	.hi	
call	.vb/.nn	.elem	
calligraphy	.nn	.hi	
calm	.aj/.vb	.elem	
calorie	.nn	.hi	
camel	.nn	.int	
camera	.nn	.elem	
camp	.nn/.vb	.elem	
campaign	.nn/.vb	.int	
campaigner	.nn	.hi	
camping	.nn	.int	
campus	.nn	.elem	
can	aux.	.elem	助動詞
Canada	.nn	.elem	
Canadian	.aj/.nn	.elem	
canal	.nn	.int	
cancel	.vb	.elem	
cancer	.nn	.elem	
candidate	.nn	.int	
candle	.nn	.elem	
candy	.nn	.elem	= sweet (British English)
cane	.nn	.int	
cannon	.nn/.vb	.hi	
canoe	.nn/.vb	.int	
canvas	.nn	.int	
canyon	.nn	.int	
cap	.nn	.elem	
capability	.nn	.hi	
capable	.aj	.int	
capacity	.nn/.aj	.int	
cape	.nn	.int	
capital	.nn	.int	資金
capital 	.nn/.aj	.int	首都，主要的
capitalism	.nn	.int	
capitalist	.aj/.nn	.int	
capsule	.nn	.hi	
captain	.nn	.elem	
caption	.nn/.vb	.int	
captive	.aj/.nn	.hi	
captivity	.nn	.hi	
capture	.vb/.nn	.int	
car	.nn	.elem	
carbohydrate	.nn	.hi	
carbon	.nn	.int	
card	.nn	.elem	
cardboard	.nn	.hi	
cardinal	.nn/.aj	.hi	
care	.nn/.vb	.elem	
career	.nn	.elem	
carefree	.aj	.hi	
careful	.aj	.elem	
careless	.aj	.elem	
caress	.vb/.nn	.hi	
caretaker	.nn	.hi	
cargo	.nn	.int	
caring	.aj	.hi	
carnation	.nn	.hi	
carnival	.nn	.hi	
carol	.nn/.vb	.hi	
carp	.nn	.hi	
carp	.vb	.hi	
carpenter	.nn	.int	
carpet	.nn	.elem	
carriage	.nn	.int	
carrier	.nn	.hi	
carrot	.nn	.elem	
carry	.vb	.elem	
c.ar	.nn/.vb	.int	
c.arel	.nn	.hi	
c.aron	.nn	.hi	
c.aroon	.nn	.elem	
carve	.vb	.int	 
case	.nn	.elem	事例,攜帶或存放物品的容器
cash	.nn/.vb	.elem	
cashier	.vb	.hi	免職
cashier	.nn	.int	出納
casino	.nn	.hi	
cassette	.nn	.elem	
cast	.nn/.vb	.int	丟，擲
cast	.vb	.int	鑄造
caste	.nn	.hi	
castle	.nn	.elem	
casual	.aj	.int	
casualty	.nn	.int	
cat	.nn	.elem	
catalog	.nn/.vb	.int	= catalogue (British English)
catastrophe	.nn	.hi	
catch	.vb/.nn	.elem	
category	.nn	.hi	
cater	.vb	.hi	
catering	.nn	.hi	
caterpillar	.nn	.int	
cathedral	.nn	.hi	
cattle	.nn	.int	
cause	.vb/.nn	.elem	
caution	.nn/.vb	.hi	
cautious	.aj	.hi	
cavalry	.nn	.hi	
cave	.nn/.vb	.int	
cavity	.nn	.hi	
CD	.nn	.elem	= compact disk
cease	.vb/.nn	.int	
ceasefire	.nn	.hi	= cease-fire
ceiling	.nn	.elem	
celebrate	.vb	.elem	
celebrated	.aj	.hi	
celebration	.nn	.int	
celebrity	.nn	.hi	
celery	.nn	.hi	
cell	.nn	.elem	
cellar	.nn	.hi	
cello	.nn	.hi	
cell-phone	.nn	.hi	= cellphone/cellular phone/mobile phone/mobile/cell
Celsius	.nn	.hi	= Centigrade/centigrade
cement	.nn/.vb	.int	
cemetery	.nn	.hi	
census	.nn	.hi	
cent	.nn	.elem	
center	.nn/.vb	.elem	= centre (British English)
centered	.aj	.hi	= centred (British English)
centimeter	.nn	.elem	= centimetre (British English)；=cm.
central	.aj	.elem	
century	.nn	.elem	
ceramic	.aj	.hi	
cereal	.nn	.elem	
ceremony	.nn	.int	
certain	.aj	.elem	
certainly	.av	.elem	
certainty	.nn	.hi	
certificate	.nn	.int	
certify	.vb	.hi	
chain	.nn/.vb	.int	
chair	.nn	.elem	
chairman	.nn	.elem	
chairperson	.nn	.hi	= chair/chairman/chairwoman
chalk	.nn	.elem	
challenge	.nn/.vb	.int	
challenged	.aj	.hi	
challenger	.nn	.hi	
challenging	.aj	.hi	
chamber	.nn	.int	
champagne	.nn	.hi	
champion	.nn/.vb	.int	
championship	.nn	.int	
chance	.nn	.elem	
change	.nn/.vb	.elem	改變,零錢
changeable	.aj	.int	
channel	.nn	.elem	
chant	.nn/.vb	.hi	
chaos	.nn	.hi	
chapel	.nn	.hi	
chapped	.aj	.hi	
chapter	.nn	.elem	
character	.nn	.elem	
characteristic	.nn/.aj	.int	
characterize	.vb	.hi	= characterise (British English)
charcoal	.nn	.hi	
charge	.nn/.vb	.elem	
chariot	.nn	.hi	
charitable	.aj	.hi	
charity	.nn	.int	
charm	.nn/.vb	.int	
charming	.aj	.int	
ch.ar	.nn	.elem	
ch.arer	.nn/.vb	.hi	
ch.arered	.aj	.hi	
chase	.vb	.elem	
chat	.vb/.nn	.int	
chatter	.vb/.nn	.hi	
cheap	.aj	.elem	
cheat	.vb/.nn	.elem	
check	.nn	.int	= cheque (British English)
check	.nn/.vb	.elem	
checkbook	.nn	.hi	
checked	.aj	.hi	
check-in	.nn	.hi	
checkout	.nn	.int	
check-up	.nn	.hi	
cheek	.nn	.int	
cheer	.vb/.nn	.elem	
cheerful	.aj	.int	
cheese	.nn	.elem	
chef	.nn	.hi	
chemical	.nn/.aj	.elem	
chemist	.nn	.int	
chemistry	.nn	.int	
cherish	.vb	.int	
cherry	.nn	.int	
chess	.nn	.elem	
chest	.nn	.int	
chestnut	.nn/.aj	.hi	
chew	.vb/.nn	.int	
chick	.nn	.int	
chicken	.nn	.elem	
chief	.aj/.nn	.elem	
child	.nn	.elem	
childbirth	.nn	.int	
childhood	.nn	.elem	
childish	.aj	.elem	
childlike	.aj	.elem	
chill	.nn/.aj	.int	
chilli	.nn	.hi	= chili
chilly	.aj	.int	
chimney	.nn	.int	
chimpanzee	.nn	.hi	
chin	.nn	.elem	
china	.nn	.int	
China	.nn	.elem	
Chinese	.aj/.nn	.elem	
chip	.nn/.vb	.int	
chirp	.vb/.nn	.hi	
chisel	.vb/.nn	.hi	
chocolate	.nn	.elem	
choice	.nn	.elem	
choir	.nn	.hi	
choke	.vb/.nn	.int	
cholesterol	.nn	.hi	
choose	.vb	.elem	
chop	.vb/.nn	.int	
chopstick	.nn	.elem	
chord	.nn	.hi	
chore	.nn	.int	
chorus	.nn	.int	
Christian	.aj/.nn	.int	
Christmas	.nn	.elem	= Xmas
chronic	.aj	.hi	
chubby	.aj	.elem	
chuck	.nn	.hi	
chuck	.vb	.hi	
chuckle	.vb/.nn	.hi	
chunk	.nn	.hi	
church	.nn	.elem	
cigar	.nn	.int	
cigarette	.nn	.int	
cinema	.nn	.int	
circle	.nn	.elem	
circuit	.nn	.hi	
circular	.aj	.int	
circulate	.vb	.int	
circulation	.nn	.int	
circumference	.nn	.hi	
circumstance	.nn	.int	
circus	.nn	.int	
cite	.vb	.hi	
citizen	.nn	.elem	
city	.nn	.elem	
civic	.aj	.hi	
civil	.aj	.int	
civilian	.aj/.nn	.int	
civilization	.nn	.int	
civilize	.vb	.int	
claim	.vb/.nn	.elem	
clam	.nn	.hi	
clamp	.nn/.vb	.hi	
clan	.nn	.hi	
clap	.vb/.nn	.elem	
clarify	.vb	.int	
clarity	.nn	.hi	
clash	.nn/.vb	.int	
clasp	.vb/.nn	.hi	
class	.nn	.elem	
classic	.aj/.nn	.elem	
classical	.aj	.elem	
classification	.nn	.int	
classify	.vb	.int	
classmate	.nn	.elem	
classroom	.nn	.int	
clause	.nn	.hi	
claw	.nn/.vb	.int	
clay	.nn	.int	
clean	.aj/.vb	.elem	
cleaner	.nn	.int	
cleanse	.vb	.hi	
clean-up	.nn	.hi	= cleanup
clear	.aj/.vb	.elem	
clearance	.nn	.hi	
clearing	.nn	.hi	
clench	.vb/.nn	.hi	
clerk	.nn	.elem	
clever	.aj	.elem	
click	.vb/.nn	.int	
client	.nn	.int	
cliff	.nn	.int	
climate	.nn	.elem	
climax	.nn	.int	
climb	.vb	.elem	
climber	.nn	.int	
climbing	.nn	.int	
clinch	.nn	.hi	
clinch	.vb	.hi	
cling	.vb	.hi	
clinic	.nn	.int	
clinical	.aj	.hi	
clip	.nn/.vb	.int	
clock	.nn	.elem	
clockwise	.av/.aj	.hi	
clone	.nn/.vb	.hi	
close	.vb/.nn	.elem	關閉,結束
close	.aj/.av	.elem	近的,密切的
closed	.aj	.hi	
closet	.nn	.elem	
closure	.nn	.hi	
cloth	.nn	.int	
clothe	.vb	.int	
clothed	.aj	.int	
clothes	.nn	.elem	
clothing	.nn	.int	
cloud	.nn/.vb	.int	
cloudy	.aj	.elem	
clover	.nn	.hi	
clown	.nn/.vb	.int	
club	.nn	.elem	
clue	.nn	.int	
clumsy	.aj	.int	
cluster	.nn/.vb	.hi	
clutch	.vb/.nn	.hi	
coach	.nn	.elem	
coal	.nn	.int	
coalition	.nn	.hi	
coarse	.aj	.int	
coast	.nn	.elem	
coastal	.aj	.hi	
coastline	.nn	.hi	
coat	.nn	.elem	
cocaine	.nn	.hi	
cock	.nn	.int	
cockpit	.nn	.hi	
cockroach	.nn	.elem	= roach
cocktail	.nn	.int	
cocoa	.nn	.hi	
coconut	.nn	.int	
cocoon	.nn/.vb	.hi	
code	.nn/.vb	.int	
coffee	.nn	.elem	
coffin	.nn	.hi	
coherent	.aj	.hi	
coil	.nn/.vb	.hi	
coin	.nn	.elem	
coincide	.vb	.hi	
coincidence	.nn	.int	
coke	.nn	.elem	
cola	.nn	.hi	= Coke
cold	.aj/.nn	.elem	
collaboration	.nn	.hi	
collapse	.vb/.nn	.int	
collar	.nn	.int	
colleague	.nn	.int	
collect	.vb	.elem	
collected	.aj	.hi	
collection	.nn	.elem	
collective	.aj/.nn	.hi	
collector	.nn	.hi	
college	.nn	.elem	
collide	.vb	.hi	
collision	.nn	.hi	
colloquial	.aj	.hi	
colonel	.nn	.hi	
colonial	.aj/.nn	.hi	
colony	.nn	.int	
color	.nn/.vb	.elem	= colour (British English)
colored	.aj	.int	
colorful	.aj	.elem	= colourful (British English)
column	.nn	.int	
columnist	.nn	.hi	
comb	.nn/.vb	.elem	
combat	.nn/.vb	.hi	
combination	.nn	.int	
combine	.vb	.int	
combined	.aj	.int	
come	.vb	.elem	
comeback	.nn	.hi	
comedian	.nn	.int	
come-down	.nn	.hi	= comedown
comedy	.nn	.int	
comet	.nn	.hi	
comfort	.nn/.vb	.int	
comfortable	.aj	.elem	
comfortably	.av	.int	
comic	.aj/.nn	.elem	
coming	.aj	.int	
comma	.nn	.hi	
command	.vb	.elem	
commander	.nn	.int	
commemorate	.vb	.hi	
commence	.vb	.hi	
commend	.vb	.hi	
comment	.nn/.vb	.elem	
commentary	.nn	.hi	
commentator	.nn	.hi	
commerce	.nn	.int	
commercial	.aj/.nn	.int	
commission	.nn/.vb	.int	
commissioner	.nn	.hi	
commit	.vb	.int	
commitment	.nn	.int	
committee	.nn	.int	
commodity	.nn	.hi	
common	.aj	.elem	
commonplace	.aj/.nn	.hi	
commonwealth	.nn	.hi	
communal	.aj	.hi	
communicate	.vb	.int	
communication	.nn	.int	
communicative	.aj	.hi	
communism	.nn	.hi	
communist	.aj/.nn	.int	
community	.nn	.int	
commute	.vb/.nn	.hi	
commuter	.nn	.hi	
compact	.nn	.hi	
compact	.aj/.vb	.hi	
companion	.nn	.int	
companionship	.nn	.hi	
company	.nn	.elem	
comparable	.aj	.hi	
comparative	.aj	.int	
compare	.vb	.elem	
compared	.aj	.int	
comparison	.nn	.int	
comp.arment	.nn	.hi	
compass	.nn	.hi	
compassion	.nn	.hi	
compassionate	.aj	.hi	
compatible	.aj	.hi	
compel	.vb	.hi	
compelling	.aj	.hi	
compensate	.vb	.hi	
compensation	.nn	.hi	
compete	.vb	.int	
competence	.nn	.hi	
competent	.aj	.hi	
competing	.aj	.hi	
competition	.nn	.int	
competitive	.aj	.int	
competitor	.nn	.int	
compile	.vb	.hi	
complain	.vb	.elem	
complaint	.nn	.int	
complement	.vb/.nn	.hi	
complete	.vb/.aj	.elem	
complex	.aj/.nn	.int	
complexion	.nn	.hi	
complexity	.nn	.hi	
complicate	.vb	.int	
complicated	.aj	.int	
complication	.nn	.hi	
compliment	.nn/.vb	.int	
comply	.vb	.hi	
component	.nn/.aj	.hi	
compose	.vb	.int	
composer	.nn	.int	
composite	.aj/.nn	.hi	
composition	.nn	.int	
compound	.nn/.aj/.vb	.int	
comprehend	.vb	.hi	
comprehension	.nn	.int	
comprehensive	.nn	.hi	
comprehensive	.aj	.hi	
compress	.nn	.hi	
compress	.vb	.hi	
comprise	.vb	.hi	
compromise	.nn/.vb	.hi	
compulsory	.aj	.hi	
compute	.vb	.int	
computer	.nn	.elem	
computerize	.vb	.hi	
computing	.nn/.aj	.hi	
comrade	.nn	.hi	
con	.nn/.vb	.hi	
conceal	.vb	.int	
concede	.vb	.hi	
conceit	.nn	.hi	
conceive	.vb	.hi	
concentrate	.vb	.int	
concentrated	.aj	.hi	
concentration	.nn	.int	
concept	.nn	.int	
conception	.nn	.hi	
concern	.nn/.vb	.elem	
concerned	.aj	.hi	
concerning	.pr	.int	
concert	.nn	.int	
concession	.nn	.hi	
concise	.aj	.hi	
conclude	.vb	.int	
conclusion	.nn	.int	
concrete	.aj/.nn	.int	
condemn	.vb	.hi	
condemnation	.nn	.hi	
condense	.vb	.hi	
condition	.nn/.vb	.int	
condom	.nn	.hi	
conduct	.vb/.nn	.int	
conductor	.nn	.int	
cone	.nn	.int	
confederation	.nn	.hi	
confer	.vb	.hi	
conference	.nn	.int	
confess	.vb	.int	
confession	.nn	.hi	
confidence	.nn	.int	
confident	.aj	.elem	
confidential	.aj	.hi	
configuration	.nn	.hi	
confine	.vb	.int	
confined	.aj	.hi	
confirm	.vb	.elem	
conflict	.nn	.elem	
conform	.vb	.hi	
confront	.vb	.int	
confrontation	.nn	.int	
Confucius	.nn	.elem	
confuse	.vb	.elem	
confusing	.aj	.hi	
confusion	.nn	.int	
congratulate	.vb	.int	
congratulation	.nn	.elem	
congress	.nn	.int	
congressional	.aj	.hi	
congressman	.nn	.hi	女性為 congresswoman
conjunction	.nn	.int	
connect	.vb	.int	
connected	.aj	.hi	
connection	.nn	.int	
conquer	.vb	.int	
conquest	.nn	.hi	
conscience	.nn	.int	
conscientious	.aj	.hi	
conscious	.aj	.int	
consciousness	.nn	.hi	
consecutive	.aj	.hi	
consensus	.nn	.hi	
consent	.nn/.vb	.hi	
consequence	.nn	.int	
consequent	.aj	.int	
consequently	.av	.int	
conservation	.nn	.hi	
conservative	.aj/.nn	.int	
conserve	.vb	.hi	
consider	.vb	.elem	
considerable	.aj	.int	
considerate	.aj	.int	
consideration	.nn	.int	
considering	.pr/.cj/.av	.hi	
consist	.vb	.int	
consistent	.aj	.int	
consolation	.nn	.hi	
console	.vb	.hi	
consolidate	.vb	.hi	
consonant	.nn	.int	
consortium	.nn	.hi	
conspicuous	.nn	.hi	
conspiracy	.nn	.hi	
constable	.nn	.hi	
constant	.aj	.int	
constituency	.nn	.hi	
constituent	.nn/.aj	.hi	
constitute	.vb	.int	
constitution	.nn	.int	
constitutional	.aj	.hi	
constrain	.vb	.hi	
constraint	.nn	.hi	
construct	.vb/.nn	.int	(P)
construction	.nn	.int	
constructive	.aj	.int	
consult	.vb	.int	
consultant	.nn	.int	
consultation	.nn	.hi	
consume	.vb	.int	
consumer	.nn	.int	
consuming	.aj	.hi	
consumption	.nn	.hi	
contact	.nn/.vb	.elem	
contagious	.aj	.hi	
contain	.vb	.elem	
container	.nn	.int	
contaminant	.aj	.hi	
contaminate	.vb	.hi	
contemplate	.vb	.hi	
contemplation	.nn	.hi	
contemporary	.aj/.nn	.int	
contempt	.nn	.hi	
contend	.vb	.hi	
contender	.nn	.hi	
content	.aj/.vb/.nn	.int	滿足
content	.nn	.int	內容，usually in plural form
contention	.nn	.hi	
contentment	.nn	.hi	
contest	.nn/.vb	.int	
contestant	.nn	.hi	
context	.nn	.int	
continent	.nn	.int	
continental	.aj	.int	
contingent	.nn	.hi	
contingent	.aj	.hi	
continual	.aj	.int	
continue	.vb	.elem	
continuity	.nn	.hi	
continuous	.aj	.int	
contract	.nn/.vb	.elem	
contractor	.nn	.hi	
contradict	.vb	.hi	
contradiction	.nn	.hi	
contradictory	.aj	.hi	
contrary	.aj	.int	
contrast	.nn/.vb	.int	(P)
contribute	.vb	.int	
contribution	.nn	.int	
contributor	.nn	.hi	
contrive	.vb	.hi	
control	.nn/.vb	.elem	
controller	.nn	.hi	
controversial	.aj	.hi	
controversy	.nn	.hi	
convene	.vb	.hi	
convenience	.nn	.int	
convenient	.aj	.elem	
convention	.nn	.int	
conventional	.aj	.int	
converge	.vb	.hi	
conversation	.nn	.elem	
converse	.vb	.int	
conversely	.av	.hi	
conversion	.nn	.hi	
convert	.vb/.nn	.hi	
convertible	.nn/.aj	.hi	
convey	.vb	.int	
convict	.vb/.nn	.hi	
conviction	.nn	.hi	
convince	.vb	.int	
convinced	.aj	.hi	
convincing	.aj	.hi	
convoy	.nn/.vb	.hi	
cook	.vb/.nn	.elem	
cooker	.nn	.int	
cookie	.nn	.elem	= cooky
cooking	.nn/.aj	.int	
cool	.aj/.vb	.elem	
co-operate	.vb	.int	= cooperate
co-operation	.nn	.hi	
co-operative	.aj	.int	
co-ordinate	.vb/.aj/.nn	.hi	= coordinate
cop	.nn/.vb	.hi	
cope	.vb	.int	
copper	.nn/.aj	.int	
copy	.nn/.vb	.elem	
copyright	.nn	.hi	
coral	.nn/.aj	.hi	
cord	.nn	.int	
cordial	.aj	.hi	
cordially	.av	.hi	
core	.nn/.vb	.hi	
cork	.nn/.vb	.hi	
corn	.nn	.elem	
corner	.nn	.elem	
corp	.nn	.hi	= corporation
corporate	.aj	.hi	
corporation	.nn	.int	
corps	.nn	.hi	
corpse	.nn	.hi	
correct	.aj/.vb	.elem	
correction	.nn	.hi	
correlate	.vb	.hi	
correspond	.vb	.int	
correspondence	.nn	.hi	
correspondent	.nn/.aj	.hi	
correspondent	.nn	.int	
corresponding	.aj	.hi	
corridor	.nn	.int	
corrode	.vb	.hi	
corrupt	.aj/.vb	.hi	
corruption	.nn	.hi	
cosmetic	.nn/.aj	.hi	
cosmic	.aj	.hi	
cosmopolitan	.aj/.nn	.hi	
cost	.nn/.vb	.elem	
costing	.nn	.hi	
costly	.aj	.int	
costume	.nn	.int	
cottage	.nn	.int	
cotton	.nn	.elem	
couch	.nn	.elem	
cough	.vb/.nn	.elem	
could	aux.	.elem	
council	.nn	.int	
councilor	.nn	.hi	= councillor (British English)
counsel	.nn/.vb	.hi	
counseling	.nn	.hi	= counselling (British English)
counselor	.nn	.hi	= counsellor (British English)
count	.vb/.nn	.elem	
countable	.aj	.hi	
counter	.nn/.vb	.int	計數器，櫃台；反抗
counterclockwise	.av/.aj	.hi	
counterp.ar	.nn	.hi	
countless	.aj	.hi	
country	.nn	.elem	
countryside	.nn	.elem	
county	.nn	.elem	
coup	.nn	.hi	
couple	.nn	.elem	
coupon	.nn	.hi	
courage	.nn	.elem	
courageous	.aj	.int	
courier	.nn	.hi	
course	.nn	.elem	
court	.nn	.elem	
courteous	.aj	.int	
courtesy	.nn	.int	
courtyard	.nn	.hi	
cousin	.nn	.elem	
cover	.vb/.nn	.elem	
coverage	.nn	.hi	
covering	.nn	.hi	
covet	.vb	.hi	
cow	.nn	.elem	
coward	.aj/.nn	.int	
cowardly	.aj	.hi	
cowboy	.nn	.int	
cozy	.aj	.hi	= cosy (British English)
crab	.nn	.elem	
crack	.nn/.vb	.int	
crackdown	.nn	.hi	
cracker	.nn	.hi	
cradle	.nn/.vb	.int	
craft	.nn	.int	
cram	.vb	.int	
cramp	.nn/.vb	.hi	
crane	.nn/.vb	.int	
crap	.nn/.vb	.hi	
crap	.aj	.hi	
crash	.nn/.vb	.int	
crater	.nn	.hi	
crawl	.vb/.nn	.int	
crayon	.nn	.elem	
crazy	.aj	.elem	
creak	.nn/.vb	.hi	
cream	.nn	.elem	
create	.vb	.elem	
creation	.nn	.int	
creative	.aj	.int	
creativity	.nn	.hi	
creator	.nn	.hi	
creature	.nn	.int	
credibility	.nn	.hi	
credible	.aj	.hi	
credit	.nn/.vb	.int	
creditor	.nn	.hi	
creek	.nn	.hi	
creep	.vb/.nn	.int	
crew	.nn	.int	
crib	.nn	.hi	
crib	.vb	.hi	
cricket	.nn	.int	
crime	.nn	.elem	
criminal	.aj/.nn	.int	
cripple	.nn/.vb	.int	
crisis	.nn	.elem	
crisp	.aj	.int	
crispy	.aj	.int	
criterion	.nn	.hi	
critic	.nn	.int	
critical	.aj	.int	
criticism	.nn	.int	
criticize	.vb	.int	
crocodile	.nn	.hi	
crook	.nn	.hi	
crook	.vb	.hi	
crooked	.aj	.hi	
crop	.nn/.vb	.int	
cross	.vb/.nn	.elem	
cross-country	.nn/.aj/.av	.hi	
crossing	.nn	.hi	= pedestrian crossing, zebra crossing, crosswalk 
crossroad	.nn	.int	usually in plural form
crouch	.vb/.nn	.hi	
crow	.nn	.int	烏鴉
crow	.vb	.int	啼叫
crowd	.nn	.elem	
crowded	.aj	.elem	
crown	.nn/.vb	.int	
crucial	.aj	.hi	
crude	.aj	.hi	
cruel	.aj	.elem	
cruelty	.nn	.int	
cruise	.nn/.vb	.hi	
cruiser	.nn	.hi	
crumb	.nn	.hi	
crumble	.nn	.hi	
crumble	.vb	.hi	
crunch	.vb/.nn	.hi	
crunchy	.aj	.hi	
crush	.vb/.nn	.int	
crust	.nn	.hi	
crutch	.nn	.int	
cry	.vb/.nn	.elem	
crystal	.nn/.aj	.int	
cub	.nn	.int	
cube	.nn/.vb	.hi	
cubic	.aj	.hi	
cucumber	.nn	.int	
cue	.nn/.vb	.int	
cuisine	.nn	.hi	
culminate	.vb	.hi	
cult	.nn/.aj	.hi	
cultivate	.vb	.int	
cultural	.aj	.int	
culture	.nn	.elem	
cumulative	.aj	.hi	
cunning	.aj	.int	
cup	.nn	.elem	
cupboard	.nn	.int	
curb	.vb/.nn	.hi	
cure	.nn/.vb	.elem	
curfew	.nn	.hi	
curiosity	.nn	.int	
curious	.aj	.elem	
curl	.vb/.nn	.int	
currency	.nn	.hi	
current	.aj/.nn	.elem	
curriculum	.nn	.hi	
curry	.nn	.hi	
curry	.vb	.hi	
curse	.nn/.vb	.int	
curtain	.nn	.elem	
curve	.nn/.vb	.elem	
cushion	.nn/.vb	.int	
custody	.nn	.hi	
custom	.nn	.elem	
customary	.aj	.hi	
customer	.nn	.elem	
cut	.vb/.nn	.elem	
cute	.aj	.elem	
cutting	.nn/.aj	.hi	
cycle	.nn/.vb	.int	
cyclist	.nn	.int	
cylinder	.nn	.hi	
cynical	.aj	.hi	
dad	.nn	.elem	= daddy= papa= pa= pop
daffodil	.nn	.hi	
daily	.aj/.av	.elem	
dairy	.nn	.int	
dam	.nn/.vb	.int	
damage	.nn/.vb	.elem	
dame	.nn	.hi	
damn	.vb/.nn	.int	
damned	.aj/.av/.nn	.hi	
damp	.aj/.nn/.vb	.int	
dance	.vb/.nn	.elem	
dancer	.nn	.int	
dancing	.nn	.int	
dandruff	.nn	.hi	
danger	.nn	.elem	
dangerous	.aj	.elem	
dare	.vb/.vb(aux.)	.int	
daring	.aj/.nn	.hi	
dark	.aj/.nn	.elem	
darling	.nn/.aj	.int	
d.ar	.vb/.nn	.hi	
dash	.vb/.nn	.int	
data	.nn	.elem	datum (singular form)
date	.nn/.vb	.elem	
daughter	.nn	.elem	
dawn	.nn/.vb	.elem	
day	.nn	.elem	
daybreak	.nn	.hi	= dawn
daylight	.nn	.int	
day-to-day	.aj	.hi	
dazzle	.vb/.nn	.hi	
dead	.aj	.elem	
deadline	.nn	.int	
deadly	.aj/.av	.hi	
deaf	.aj	.elem	
deafen	.vb	.hi	
deal	.vb/.nn	.elem	
dealer	.nn	.hi	
dealing	.nn	.hi	
dear	.aj/int./.nn	.elem	
death	.nn	.elem	
debate	.nn/.vb	.elem	
debris	.nn	.hi	
debt	.nn	.elem	
debut	.nn	.hi	
decade	.nn	.int	
decay	.vb/.nn	.int	
deceive	.vb	.int	
December	.nn	.elem	= Dec.
decent	.aj	.hi	
decide	.vb	.elem	
decimal	.aj/.nn	.hi	
decision	.nn	.elem	
decisive	.aj	.hi	
deck	.nn	.int	
declaration	.nn	.int	
declare	.vb	.int	
decline	.vb	.int	
decorate	.vb	.elem	
decoration	.nn	.int	
decorative	.aj	.hi	
decrease	.vb/.nn	.elem	
decree	.nn/.vb	.hi	
dedicate	.vb	.hi	
dedicated	.aj	.hi	
dedication	.nn	.hi	
deduce	.vb	.hi	
deduct	.vb	.hi	
deduction	.nn	.hi	
deed	.nn	.int	
deem	.vb	.hi	
deep	.aj/.av	.elem	
deepen	.vb	.hi	
deer	.nn	.elem	
default	.vb/.nn	.hi	
defeat	.nn/.vb	.int	
defect	.nn	.hi	
defect	.vb	.hi	
defend	.vb	.int	
defendant	.nn	.hi	
defender	.nn	.hi	
defense	.nn	.int	= defence (British English)
defensible	.aj	.hi	
defensive	.aj	.int	
defiance	.nn	.hi	
defiant	.aj	.hi	
deficiency	.nn	.hi	
deficient	.aj	.hi	
deficit	.nn	.int	
define	.vb	.int	
definite	.aj	.int	
definitely	.av	.hi	
definition	.nn	.int	
definitive	.aj	.hi	
defy	.vb	.hi	
degenerate	.vb/.aj/.nn	.hi	
degrade	.vb	.hi	
degree	.nn	.elem	
delay	.nn/.vb	.elem	
delegate	.nn/.vb	.int	
delegation	.nn	.hi	
delete	.vb	.int	
deliberate	.aj/.vb	.hi	
delicate	.aj	.int	
delicious	.aj	.elem	
delight	.nn/.vb	.int	
delighted	.aj	.int	
delightful	.aj	.int	
delinquent	.nn/.aj	.hi	
deliver	.vb	.elem	
delivery	.nn	.int	
demand	.nn/.vb	.int	
demanding	.aj	.int	
demise	.nn	.hi	
democracy	.nn	.elem	
democrat	.nn	.int	
democratic	.aj	.elem	
demonstrate	.vb	.int	
demonstration	.nn	.int	
demonstrator	.nn	.hi	
denial	.nn	.hi	
denote	.vb	.hi	
de.nnce	.vb	.hi	
dense	.aj	.int	
density	.nn	.hi	
dental	.aj	.hi	
dentist	.nn	.elem	
deny	.vb	.elem	
dep.ar	.vb	.int	
dep.arment	.nn	.elem	
dep.arure	.nn	.int	
depend	.vb	.elem	
dependable	.aj	.int	
dependent	.aj/.nn	.int	= dependant
depict	.vb	.hi	
deplete	.vb	.hi	
deploy	.vb	.hi	
deployment	.nn	.hi	
deport	.vb	.hi	
deposit	.nn/.vb	.int	
depress	.vb	.int	
depressed	.aj	.int	
depressing	.aj	.int	
depression	.nn	.int	
deprive	.vb	.hi	
depth	.nn	.int	
deputy	.nn	.int	
derive	.vb	.hi	
descend	.vb	.hi	
descendant	.nn	.hi	
descent	.nn	.hi	
describe	.vb	.elem	
description	.nn	.int	
descriptive	.aj	.hi	
desert	.vb	.elem	遺棄
desert	.nn	.elem	沙漠
deserve	.vb	.int	
design	.nn/.vb	.elem	
designate	.vb/.aj	.hi	
designer	.nn	.int	
desirable	.aj	.hi	
desire	.nn/.vb	.elem	
desk	.nn	.elem	
despair	.nn/.vb	.int	
desperate	.aj	.int	
despise	.vb	.hi	
despite	.pr	.int	
dessert	.nn	.elem	
destination	.nn	.int	
destined	.aj	.hi	
destiny	.nn	.hi	
destroy	.vb	.int	
destruction	.nn	.int	
destructive	.aj	.int	
detach	.vb	.hi	
detached	.aj	.hi	
detail	.nn/.vb	.int	
detailed	.aj	.int	
detain	.vb	.hi	
detect	.vb	.int	
detection	.nn	.hi	
detective	.nn/.aj	.int	
detention	.nn	.hi	
deter	.vb	.hi	
detergent	.nn/.aj	.int	
deteriorate	.vb	.hi	
deterioration	.nn	.hi	
determination	.nn	.int	
determine	.vb	.elem	
determined	.aj	.int	
devalue	.vb	.hi	
devastate	.vb	.hi	
devastating	.aj	.hi	
develop	.vb	.elem	
developed	.aj	.hi	
developer	.nn	.hi	
developing	.aj	.hi	
development	.nn	.int	
deviate	.vb	.hi	
device	.nn	.int	
devil	.nn	.int	
devise	.vb	.int	
devote	.vb	.int	
devoted	.aj	.int	
devotion	.nn	.int	
devour	.vb	.hi	
dew	.nn	.hi	
diabetes	.nn	.hi	
diagnose	.vb	.hi	
diagnosis	.nn	.hi	
diagram	.nn	.hi	
dial	.vb/.nn	.elem	
dialect	.nn	.int	
dialog	.nn	.int	= dialogue (British English)
diameter	.nn	.hi	
diamond	.nn	.elem	
diaper	.nn	.hi	
diary	.nn	.elem	
dictate	.vb	.int	
dictation	.nn	.int	
dictator	.nn	.hi	
dictatorship	.nn	.hi	
dictionary	.nn	.elem	
die	.vb	.elem	
diesel	.nn	.hi	
diet	.nn/.vb/.aj	.elem	
differ	.vb	.int	
difference	.nn	.elem	
different	.aj	.elem	
differentiate	.vb	.hi	
difficult	.aj	.elem	
difficulty	.nn	.elem	
diffuse	.vb	.hi	
dig	.vb	.elem	
digest	.vb/.nn	.int	(P)
digestion	.nn	.int	
digit	.nn	.int	
digital	.aj	.int	
dignity	.nn	.int	
dilemma	.nn	.hi	
diligence	.nn	.hi	
diligent	.aj	.elem	
dilute	.vb/.aj	.hi	
dim	.aj/.vb	.int	
dime	.nn	.int	
dimension	.nn	.hi	
diminish	.vb	.hi	
dine	.vb	.int	
dinner	.nn	.elem	
dinosaur	.nn	.elem	
dip	.vb/.nn	.int	
diploma	.nn	.int	
diplomacy	.nn	.hi	
diplomat	.nn	.elem	
diplomatic	.aj	.hi	
direct	.aj/.vb	.elem	
direction	.nn	.elem	
directive	.nn	.hi	
directly	.av	.hi	
director	.nn	.elem	
directory	.nn	.hi	
dirt	.nn	.int	
dirty	.aj/.vb	.elem	
disability	.nn	.hi	
disable	.vb	.hi	
disabled	.aj	.int	
disadvantage	.nn/.vb	.int	
disadvantaged	.aj	.int	
disagree	.vb	.int	
disagreement	.nn	.hi	
disappear	.vb	.elem	
disappoint	.vb	.int	
disappointed	.aj	.int	
disappointing	.aj	.int	
disappointment	.nn	.int	
disapproval	.nn	.int	
disapprove	.vb	.int	
disaster	.nn	.int	
disastrous	.aj	.hi	
disbelief	.nn	.hi	
discard	.vb/.nn	.int	
discern	.vb	.hi	
discharge	.vb/.nn	.hi	
disciple	.nn	.hi	
disciplinary	.aj	.hi	
discipline	.nn/.vb	.int	
disclose	.vb	.hi	
disclosure	.nn	.hi	
disco	.nn	.int	= discotheque
discomfort	.nn	.hi	
disconnect	.vb	.int	
discount	.nn/.vb	.int	
discourage	.vb	.int	
discover	.vb	.elem	
discovery	.nn	.int	
discredit	.vb/.nn	.hi	
discreet	.aj	.hi	
discrepancy	.nn	.hi	
discrete	.aj	.hi	
discretion	.nn	.hi	
discriminate	.vb	.hi	
discrimination	.nn	.hi	
discuss	.vb	.elem	
discussion	.nn	.elem	
disease	.nn	.int	
disgrace	.nn/.vb	.hi	
disgraceful	.aj	.hi	
disguise	.nn/.vb	.int	
disgust	.vb/.nn	.int	
dish	.nn	.elem	
dishonest	.aj	.elem	
disintegrate	.vb	.hi	
disk	.nn	.int	= disc
dislike	.vb/.nn	.int	
dismantle	.vb	.hi	
dismay	.nn/.vb	.hi	
dismiss	.vb	.int	
dismissal	.nn	.hi	
disorder	.nn/.vb	.int	
dispatch	.vb/.nn	.hi	= despatch (British English)
dispensable	.aj	.hi	
dispense	.vb	.hi	
disperse	.vb	.hi	
displace	.vb	.hi	
display	.vb/.nn	.int	
displease	.vb	.hi	
disposable	.aj/.nn	.hi	
disposal	.nn	.hi	
dispose	.vb	.hi	
disposition	.nn	.hi	
dispute	.vb/.nn	.int	
disregard	.vb/.nn	.hi	
disrupt	.vb	.hi	
dissatisfaction	.nn	.int	
dissent	.nn/.vb	.hi	
dissident	.nn/.aj	.hi	
dissipate	.vb	.hi	
dissolve	.vb	.int	
dissuade	.vb	.hi	
distance	.nn	.elem	
distant	.aj	.int	
distil	.vb	.hi	
distinct	.aj	.int	
distinction	.nn	.int	
distinctive	.aj	.hi	
distinguish	.vb	.int	
distinguished	.aj	.int	
distort	.vb	.hi	
distract	.vb	.hi	
distraction	.nn	.hi	
distress	.nn/.vb	.hi	
distribute	.vb	.int	
distributed	.aj	.hi	
distribution	.nn	.int	
distributor	.nn	.hi	
district	.nn	.int	
distrust	.vb/.nn	.int	
disturb	.vb	.int	
disturbance	.nn	.int	
disturbed	.aj	.hi	
disturbing	.aj	.hi	
ditch	.nn/.vb	.int	
dive	.vb/.nn	.int	
diverse	.aj	.hi	
diversify	.vb	.hi	
diversion	.nn	.hi	
diversity	.nn	.hi	
divert	.vb	.hi	
divide	.vb	.elem	
dividend	.nn	.hi	
divine	.aj	.int	
division	.nn	.elem	
divorce	.nn/.vb	.int	
divorced	.aj	.hi	
dizzy	.aj	.elem	
do	.vb	.elem	
do	aux.	.elem	
dock	.nn/.vb	.int	
doctor	.nn	.elem	= doc.= physician 
doctrine	.nn	.hi	
document	.nn	.elem	
documentary	.nn/.aj	.hi	
dodge	.vb/.nn	.hi	
dog	.nn	.elem	
doll	.nn	.elem	
dollar	.nn	.elem	= buck
dolphin	.nn	.elem	
domain	.nn	.hi	
dome	.nn	.hi	
domestic	.aj	.int	
dominant	.aj	.int	
dominate	.vb	.int	
donate	.vb	.int	
donation	.nn	.hi	
donkey	.nn	.elem	
donor	.nn/.aj	.hi	
doom	.nn/.vb	.hi	
doomed	.aj	.hi	
door	.nn	.elem	
doorstep	.nn	.hi	
doorway	.nn	.hi	
dormitory	.nn	.int	= dorm
dosage	.nn	.hi	
dose	.nn	.int	
dot	.nn	.elem	
double	.aj/.vb/.nn	.elem	
Double Tenth Day	.nn	.elem	
doubt	.nn/.vb	.elem	
doubtful	.aj	.int	
doubtless	.av	.hi	
dough	.nn	.hi	
doughnut	.nn	.elem	= donut
dove	.nn	.int	
down	.av/.pr/.nn/.aj	.elem	
download	.vb	.hi	
downstairs	.av/.aj	.elem	
downtown	.av/.aj/.nn	.elem	
downwards	.av	.int	
doze	.vb/.nn	.int	
dozen	.nn	.elem	
Dr.	.nn	.elem	= Dr (British English)
draft	.nn/.vb	.int	
drag	.vb/.nn	.int	
dragon	.nn	.elem	
Dragon-boat Festival	.nn	.elem	
dragonfly	.nn	.int	
drain	.vb/.nn	.int	
drainage	.nn	.hi	
drama	.nn	.elem	
dramatic	.aj	.int	
drape	.vb/.nn	.hi	
drastic	.aj	.hi	
draught	.nn/.aj	.hi	noun= draft
draw	.vb	.elem	
drawback	.nn	.hi	
drawer	.nn	.elem	
drawing	.nn	.int	
dread	.nn/.vb	.int	
dreadful	.aj	.int	
dream	.nn/.vb	.elem	
dreary	.aj	.hi	
dress	.vb/.nn	.elem	
dressed	.aj	.hi	
dresser	.nn	.elem	
dressing	.nn	.hi	
dried	.aj	.hi	
drift	.vb/.nn	.int	
drill	.nn/.vb	.int	
drink	.vb/.nn	.elem	
drip	.vb/.nn	.int	
drive	.vb/.nn	.elem	
driver	.nn	.elem	
driveway	.nn	.hi	= drive (road)
drizzle	.nn/.vb	.hi	
drop	.vb/.nn	.elem	
drought	.nn	.int	
drown	.vb	.int	
drowsy	.aj	.int	
drug	.nn	.elem	
drugstore	.nn	.elem	
drum	.nn	.elem	
drunk	.aj/.nn	.int	
dry	.aj/.vb	.elem	
dryer	.nn	.elem	
dual	.aj	.hi	
dub	.vb	.hi	
dubious	.aj	.hi	
duck	.nn	.elem	
duckling	.nn	.int	
due	.aj	.int	
dull	.aj	.int	
dumb	.aj	.elem	
dump	.vb/.nn	.int	
dumpling	.nn	.elem	
duplicate	.vb/.nn/.aj	.hi	
durable	.aj	.int	
duration	.nn	.int	
during	.pr	.elem	
dusk	.nn	.int	
dust	.nn/.vb	.int	
dusty	.aj	.int	
duty	.nn	.elem	
DVD	.nn	.hi	= digital video disk/digital versatile disk
dwarf	.vb/.nn/.aj	.hi	
dwell	.vb	.hi	
dwelling	.nn	.hi	
dye	.nn/.vb	.int	
dying	.aj	.hi	
dynamic	.aj	.int	
dynamite	.nn/.vb	.hi	
dynasty	.nn	.int	
each	.pn/.aj/.av	.elem	
eager	.aj	.int	
eagle	.nn	.elem	
ear	.nn	.elem	
early	.aj/.av	.elem	
earn	.vb	.elem	
earnest	.aj/.nn	.int	
earnings	.nn	.int	
earphones	.nn	.hi	
earring	.nn	.int	
e.arh	.nn	.elem	
e.arhquake	.nn	.int	
ease	.vb/.nn	.int	
easily	.av	.int	
east	.nn/.av/.aj	.elem	
Easter	.nn	.elem	
eastern	.aj	.elem	
easy	.aj	.elem	
eat	.vb	.elem	
ebb	.nn/.vb	.hi	
eccentric	.aj/.nn	.hi	
echo	.nn/.vb	.int	
eclipse	.nn/.vb	.hi	
ecological	.aj	.hi	
ecology	.nn	.hi	
economic	.aj	.int	
economical	.aj	.int	
economics	.nn	.int	
economist	.nn	.int	
economy	.nn	.int	
ecstasy	.nn	.hi	
ecstatic	.aj	.hi	
edge	.nn	.elem	
edged	.aj	.hi	
edible	.aj	.int	
edit	.vb	.int	
edition	.nn	.int	
editor	.nn	.int	= ed.
editorial	.aj/.nn	.int	
educate	.vb	.int	
educated	.aj	.hi	
education	.nn	.elem	
educational	.aj	.int	
eel	.nn	.hi	
effect	.nn/.vb	.elem	
effective	.aj	.elem	
efficiency	.nn	.int	
efficient	.aj	.int	
effort	.nn	.elem	
egg	.nn	.elem	
ego	.nn	.hi	
eight	.nu/.pn/.nn/.aj	.elem	
eighteen	.nu/.pn/.nn/.aj	.elem	
eighty	.nu/.pn/.nn/.aj	.elem	
either	.av	.elem	也(用於否定句尾)
either	.pn/.aj/.cj	.elem	兩者之中任一(的)
eject	.vb	.hi	
elaborate	.aj/.vb	.int	
elapse	.vb	.hi	
elastic	.aj	.int	
elbow	.nn/.vb	.int	
elder	.nn/.aj	.elem	
elderly	.aj	.int	
elect	.vb	.elem	
election	.nn	.elem	
electoral	.aj	.hi	
electorate	.nn	.hi	
electric	.aj	.elem	
electrical	.aj	.int	
electrician	.nn	.int	
electricity	.nn	.int	
electron	.nn	.hi	
electronic	.aj	.int	
electronics	.nn	.int	
elegant	.aj	.int	
element	.nn	.elem	
elementary	.aj	.int	
elephant	.nn	.elem	
elevate	.vb	.hi	
elevated	.aj	.hi	
elevation	.nn	.hi	
elevator	.nn	.int	
eleven	.nu/.pn/.nn/.aj	.elem	
elicit	.vb	.hi	
eligibility	.nn	.hi	
eligible	.aj	.hi	
eliminate	.vb	.int	
elite	.nn/.aj	.hi	
eloquence	.nn	.hi	
eloquent	.aj	.hi	
else	.av/.aj	.elem	
elsewhere	.av	.int	
e-mail	.nn/.vb	.elem	
embargo	.nn/.vb	.hi	
embark	.vb	.hi	
embarrass	.vb	.elem	
embarrassment	.nn	.hi	
embassy	.nn	.int	
embed	.vb	.hi	
embody	.vb	.hi	
embrace	.vb/.nn	.hi	
embryo	.nn/.aj	.hi	
emerge	.vb	.int	
emergence	.nn	.hi	
emergency	.nn	.int	
emigrant	.nn	.hi	
emigrate	.vb	.hi	
emigration	.nn	.hi	
emission	.nn	.hi	
emit	.vb	.hi	
emotion	.nn	.elem	
emotional	.aj	.int	
emperor	.nn	.int	
emphasis	.nn	.int	
emphasize	.vb	.elem	= emphasise (British English)
emphatic	.aj	.hi	
empire	.nn	.int	
empirical	.aj	.hi	
employ	.vb	.elem	
employee	.nn	.int	
employer	.nn	.int	
employment	.nn	.int	
empty	.aj/.vb	.elem	
enable	.vb	.int	
enact	.vb	.hi	
enclose	.vb	.int	
enclosed	.aj	.int	
enclosure	.nn	.hi	
encounter	.vb/.nn	.int	
encourage	.vb	.elem	
encouragement	.nn	.int	
encouraging	.aj	.hi	
encyclopedia	.nn	.hi	
end	.nn/.vb	.elem	
endanger	.vb	.int	
endeavor	.vb/.nn	.hi	= endeavour (British English)
ending	.nn	.int	
endless	.aj	.hi	
endorse	.vb	.hi	
endow	.vb	.hi	
endowment	.nn	.hi	
endurance	.nn	.int	
endure	.vb	.int	
enemy	.nn	.elem	
energetic	.aj	.int	
energize	.vb	.hi	
energy	.nn	.elem	
enforce	.vb	.int	
enforcement	.nn	.hi	
engage	.vb	.int	
engaged	.aj	.hi	
engagement	.nn	.hi	
engine	.nn	.elem	
engineer	.nn	.elem	
engineering	.nn	.int	
England	.nn	.elem	
English	.aj/.nn	.elem	
Englishman	.nn	.elem	
enhance	.vb	.int	
enjoy	.vb	.elem	
enjoyable	.aj	.int	
enjoyment	.nn	.int	
enlarge	.vb	.int	
enlargement	.nn	.int	
enlighten	.vb	.hi	
enormous	.aj	.int	
enough	.av/.aj/.pn	.elem	
enrich	.vb	.hi	
enroll	.vb	.int	= enrol (British English)
ensue	.vb	.hi	
ensure	.vb	.int	
entail	.vb	.hi	
enter	.vb	.elem	
enterprise	.nn	.int	
entertain	.vb	.int	
entertainer	.nn	.int	
entertainment	.nn	.int	
enthusiasm	.nn	.int	
enthusiast	.nn	.hi	
enthusiastic	.aj	.int	
entire	.aj	.elem	
entitle	.vb	.int	
entity	.nn	.hi	
entrance	.nn	.elem	
entrepreneur	.nn	.hi	
entry	.nn	.int	
envelope	.nn	.elem	
envious	.aj	.int	
environment	.nn	.elem	
environmental	.aj	.int	
environmentalist	.nn	.hi	
envisage	.vb	.hi	
envoy	.nn	.hi	
envy	.nn/.vb	.elem	
enzyme	.nn	.hi	
epic	.nn/.aj	.hi	
epidemic	.nn/.aj	.hi	
episode	.nn	.hi	
epoch	.nn	.hi	
EQ	.nn	.hi	= emotional quotient/emotional intelligence
equal	.aj/.vb/.nn	.elem	
equality	.nn	.int	
equate	.vb	.hi	
equation	.nn	.hi	
equator	.nn	.hi	
equilibrium	.nn	.hi	
equip	.vb	.int	
equipment	.nn	.int	
equity	.nn	.hi	
equivalent	.aj/.nn	.int	
era	.nn	.int	
erase	.vb	.int	
eraser	.nn	.elem	
erect	.vb	.int	
erode	.vb	.hi	
erosion	.nn	.hi	
erotic	.aj	.hi	
errand	.nn	.int	
erroneous	.aj	.hi	
error	.nn	.elem	
erupt	.vb	.hi	
eruption	.nn	.hi	
escalate	.vb	.hi	
escalator	.nn	.int	
escape	.vb/.nn	.int	
escort	.nn/.vb	.hi	
especially	.av	.elem	
essay	.nn	.int	
essence	.nn	.hi	
essential	.aj	.int	
essentially	.av	.int	
establish	.vb	.int	
established	.aj	.hi	
establishment	.nn	.hi	
estate	.nn	.int	
esteem	.nn/.vb	.hi	
estimate	.vb/.nn	.int	
etc.	.av	.int	= et cetera
eternal	.aj	.hi	
eternity	.nn	.hi	
ethic	.nn	.hi	
ethical	.aj	.hi	
ethics	.nn	.hi	
ethnic	.aj	.hi	
Europe	.nn	.elem	
European	.aj/.nn	.elem	
evacuate	.vb	.hi	
evacuation	.nn	.hi	
evaluate	.vb	.int	
evaluation	.nn	.hi	
evaporate	.vb	.hi	
evaporation	.nn	.hi	
eve	.nn	.elem	
even	.aj	.int	平坦的,平等的
even	.av	.elem	甚至
evening	.nn	.elem	
event	.nn	.elem	
eventual	.aj	.int	
eventually	.av	.int	
ever	.av	.elem	
evergreen	.aj/.nn	.hi	
every	.aj	.elem	
everybody	.pn	.elem	
everyday	.aj	.int	
everyone	.pn	.elem	= everybody
everything	.pn	.elem	
everywhere	.av	.elem	
evidence	.nn/.vb	.int	
evident	.aj	.int	
evidently	.av	.hi	
evil	.nn/.aj	.elem	
evoke	.vb	.hi	
evolution	.nn	.int	
evolve	.vb	.int	
exact	.aj	.elem	
exactly	.av	.int	
exaggerate	.vb	.int	
exaggerated	.aj	.hi	
exaggeration	.nn	.hi	
exam	.nn	.elem	= examination
examination	.nn	.int	= exam
examine	.vb	.elem	
examinee	.nn	.hi	
examiner	.nn	.int	
example	.nn	.elem	
exceed	.vb	.hi	
exceedingly	.av	.hi	
excel	.vb	.hi	
excellence	.nn	.int	
excellent	.aj	.elem	
except	.cj/.pr	.elem	
exception	.nn	.int	
exceptional	.aj	.int	
excerpt	.nn/.vb	.hi	
excess	.aj/.nn	.hi	
excessive	.aj	.hi	
exchange	.nn/.vb	.int	
excite	.vb	.elem	
excited	.aj	.elem	
excitedly	.av	.int	
excitement	.nn	.int	
exciting	.aj	.elem	
exclaim	.vb	.int	
exclude	.vb	.hi	
exclusion	.nn	.hi	
exclusive	.aj/.nn	.hi	
exclusively	.av	.hi	
excursion	.nn	.int	
excuse	.nn/.vb	.elem	
execute	.vb	.hi	
execution	.nn	.hi	
executive	.nn/.aj	.int	
exemplify	.vb	.hi	
exempt	.aj/.vb	.hi	
exercise	.nn/.vb	.elem	
exert	.vb	.hi	
exhaust	.vb	.int	
exhaust	.nn	.int	廢氣
exhibit	.vb/.nn	.int	
exhibition	.nn	.int	
exile	.nn/.vb	.hi	
exist	.vb	.elem	
existence	.nn	.int	
existing	.aj	.hi	
exit	.nn/.vb	.elem	
exotic	.aj	.hi	
expand	.vb	.int	
expansion	.nn	.int	
expect	.vb	.elem	
expectation	.nn	.int	
expedition	.nn	.hi	
expel	.vb	.hi	
expend	.vb	.hi	
expenditure	.nn	.hi	
expense	.nn	.int	
expensive	.aj	.elem	
experience	.nn/.vb	.elem	
experienced	.aj	.hi	
experiment	.nn/.vb	.int	
experimental	.aj	.int	
expert	.nn	.elem	
expertise	.nn	.hi	
expiration	.nn	.hi	
expire	.vb	.hi	
explain	.vb	.elem	
explanation	.nn	.int	
explicit	.aj	.hi	
explode	.vb	.int	
exploit	.vb	.int	
exploration	.nn	.hi	
explore	.vb	.int	
explorer	.nn	.int	
explosion	.nn	.int	
explosive	.aj/.nn	.int	
export	.nn/.vb	.elem	
expose	.vb	.int	
exposition	.nn	.hi	
exposure	.nn	.int	
express	.vb/.nn/.aj	.elem	
expression	.nn	.int	
expressive	.aj	.hi	
expulsion	.nn	.hi	
exquisite	.aj	.hi	
extend	.vb	.int	
extension	.nn	.int	= ext.
extensive	.aj	.int	
extent	.nn	.int	
exterior	.nn/.aj	.hi	
external	.aj	.hi	
externals	.nn	.hi	
extinct	.aj	.int	
extinguish	.vb	.hi	
extra	.aj	.elem	
extract	.vb/.nn	.hi	
extracurricular	.aj	.hi	
extradite	.vb	.hi	
extraordinary	.aj	.int	
extravagant	.aj	.hi	
extreme	.aj/.nn	.int	
extremely	.av	.int	
extremist	.nn/.aj	.hi	
eye	.nn	.elem	
eyebrow	.nn	.int	
eyelash	.nn	.hi	= lash
eyelid	.nn	.hi	
eyesight	.nn	.int	
fable	.nn	.int	
fabric	.nn	.hi	
fabricate	.vb	.hi	
fabulous	.aj	.hi	
face	.nn/.vb	.elem	
facet	.nn	.hi	
facial	.aj	.int	
facilitate	.vb	.hi	
facility	.nn	.int	
fact	.nn	.elem	
faction	.nn	.hi	
factor	.nn	.int	
factory	.nn	.elem	
faculty	.nn	.hi	
fad	.nn	.hi	
fade	.vb	.int	
Fahrenheit	.nn	.hi	
fail	.vb	.elem	
failure	.nn	.elem	
faint	.aj/.vb/.nn	.int	
fair	.aj	.elem	公正的,美好的
fair	.nn	.elem	商品展覽會
fairly	.av	.int	
fairy	.nn/.aj	.int	
faith	.nn	.int	
faithful	.aj	.int	
faithfully	.av	.hi	
fake	.aj/.nn/.vb	.int	
fall	.nn	.elem	= autumn 秋天
fall	.vb	.elem	掉落
false	.aj	.elem	
falter	.vb	.hi	
fame	.nn	.int	
familiar	.aj	.int	
familiarity	.nn	.hi	
family	.nn	.elem	
famine	.nn	.hi	
famous	.aj	.elem	
fan	.nn	.elem	
fancy	.aj	.elem	
fantastic	.aj	.elem	
fantasy	.nn	.int	
far	.av/.aj	.elem	
fare	.nn	.int	
farewell	.nn/.aj	.int	
farm	.nn	.elem	
farmer	.nn	.elem	
farming	.nn	.hi	
fascinate	.vb	.int	
fascinated	.aj	.int	
fascinating	.aj	.int	
fascination	.nn	.hi	
Fascism	.nn	.hi	
fascist	.aj/.nn	.hi	
fashion	.nn/.vb	.int	
fashionable	.aj	.elem	
fast	.aj/.av	.elem	
fasten	.vb	.int	
fat	.aj/.nn	.elem	
fatal	.aj	.int	
fate	.nn	.int	
father	.nn	.elem	
fatigue	.nn	.hi	
fatty	.aj/.nn	.hi	
faucet	.nn	.elem	
fault	.nn	.elem	
faulty	.aj	.int	
favor	.vb/.nn	.elem	= favour (British English)
favorable	.aj	.int	
favorite	.aj/.nn	.elem	= favourite (British English)
fax	.nn/.vb	.int	noun= facsimile
fear	.nn/.vb	.elem	
fearful	.aj	.hi	
feasible	.aj	.hi	
feast	.nn/.vb	.int	
feat	.nn	.hi	
feather	.nn	.int	
feature	.nn/.vb	.int	
February	.nn	.elem	= Feb. 
federal	.aj/.nn	.int	
federation	.nn	.hi	
fee	.nn	.elem	
feeble	.aj	.hi	
feed	.vb	.elem	
feedback	.nn	.int	
feeder	.aj/.nn	.hi	
feel	.vb	.elem	
feeling	.nn	.elem	
fellow	.nn/.aj	.elem	
fellowship	.nn	.hi	
female	.aj/.nn	.elem	
feminine	.aj	.hi	
feminism	.nn	.hi	
feminist	.nn/.aj	.hi	
fence	.nn	.elem	
ferry	.nn/.vb	.int	
fertile	.aj	.int	
fertility	.nn	.hi	
fertilizer	.nn	.int	
festival	.nn	.elem	
fetch	.vb/.nn	.int	
fever	.nn	.elem	
few	.pn/.aj	.elem	
fiancé	.nn	.hi	未婚夫為fiancé，未婚妻為fiancée
fiber	.nn	.hi	= fibre (British English)
fiction	.nn	.int	
fiddle	.nn/.vb	.hi	
fidelity	.nn	.hi	
field	.nn	.elem	
fierce	.aj	.int	
fifteen	.nu/.pn/.nn/.aj	.elem	
fifty	.nu/.pn/.nn/.aj	.elem	
fight	.vb/.nn	.elem	
fighter	.nn	.int	
figure	.nn/.vb	.elem	
file	.nn/.vb	.int	
fill	.vb	.elem	
film	.nn	.elem	
filter	.vb/.nn	.hi	
fin	.nn	.hi	
final	.aj/.nn	.elem	
finally	.av	.elem	
finance	.nn/.vb	.int	
financial	.aj	.int	
find	.vb	.elem	
finding	.nn	.hi	
fine	.aj	.elem	極好的,非常健康的
fine	.vb/.nn	.elem	罰款
finger	.nn	.elem	
finish	.vb/.nn	.elem	
finished	.aj	.int	
finite	.aj	.hi	
fire	.nn/.vb	.elem	火,燃燒;開除
firecracker	.nn	.hi	
firefighter	.nn	.hi	= fireman
fireplace	.nn	.int	
fireproof	.aj	.hi	
firework	.nn	.int	
firm	.nn	.elem	商行
firm	.aj	.elem	堅固的 
first	.aj/.av/.pn	.elem	
first-class	.aj/.av	.hi	= first class
fiscal	.aj	.hi	
fish	.nn/.vb	.elem	
fisherman	.nn	.elem	
fishery	.nn	.hi	
fishing	.nn	.int	
fist	.nn/.vb	.int	
fit	.nn	.int	一陣;(病)發作
fit	.vb	.elem	使適合 
fitting	.nn/.aj	.hi	
five	.nu/.pn/.nn/.aj	.elem	
fix	.vb	.elem	
fixed	.aj	.hi	
fixture	.nn	.hi	
flag	.nn	.elem	
flake	.nn/.vb	.hi	
flame	.nn/.vb	.int	
flank	.nn/.vb	.hi	
flap	.vb/.nn	.hi	
flare	.nn/.vb	.hi	
flash	.nn/.vb	.int	
flashlight	.nn	.elem	= flash
flat	.nn	.elem	= apartment
flat	.aj	.elem	
flatter	.vb	.int	
flavor	.nn/.vb	.int	= flavour (British English)
flaw	.nn/.vb	.hi	
flea	.nn	.int	
flee	.vb	.int	
fleet	.nn	.hi	
flesh	.nn	.int	
flexible	.aj	.int	
flick	.vb/.nn	.hi	
flicker	.vb/.nn	.hi	
flight	.nn	.elem	
fling	.nn	.hi	
fling	.vb	.hi	
float	.vb/.nn	.int	
flock	.nn/.vb	.int	
flood	.nn/.vb	.int	
flooding	.nn	.int	
floor	.nn	.elem	
flop	.vb/.nn	.hi	
flounder	.nn	.hi	
flounder	.vb	.hi	
flour	.nn	.elem	
flourish	.vb/.nn	.hi	
flow	.nn/.vb	.elem	
flower	.nn	.elem	
flu	.nn	.elem	
fluctuate	.vb	.hi	
fluency	.nn	.hi	
fluent	.aj	.int	
fluid	.nn/.aj	.hi	
flunk	.vb	.hi	
flush	.vb/.nn	.int	
flute	.nn	.elem	
flutter	.vb/.nn	.hi	
fly	.vb	.elem	飛
fly	.nn	.elem	蒼蠅
foam	.nn/.vb	.int	
focus	.vb/.nn	.elem	
foe	.nn	.hi	
fog	.nn	.elem	
foggy	.aj	.int	
foil	.nn	.hi	
foil	.vb	.hi	
fold	.vb/.nn	.int	
folk	.nn/.aj	.int	
folklore	.nn	.hi	
follow	.vb	.elem	
follower	.nn	.int	
following	.aj/.pr/.pn/.nn	.elem	
follow-up	.nn	.hi	
fond	.aj	.int	
food	.nn	.elem	
fool	.nn/.aj/.vb	.elem	
foolish	.aj	.elem	
foot	.nn	.elem	= ft.
footage	.nn	.hi	
football	.nn	.elem	
footstep	.nn	.hi	
for	.pr/.cj	.elem	
forbid	.vb	.int	
forbidden	.aj	.hi	
force	.nn/.vb	.elem	
forecast	.nn/.vb	.int	
forehead	.nn	.int	= brow (British English)
foreign	.aj	.elem	
foreigner	.nn	.elem	
foremost	.aj	.hi	
foresee	.vb	.int	
forest	.nn	.elem	
forever	.av	.int	
forge	.nn	.hi	
forge	.vb	.hi	
forget	.vb	.elem	
forgetful	.aj	.int	
forgive	.vb	.elem	
fork	.nn	.elem	
form	.nn/.vb	.elem	
formal	.aj	.elem	
format	.nn/.vb	.hi	
formation	.nn	.int	
former	.pn/.aj	.elem	
formidable	.aj	.hi	
formula	.nn	.int	
formulate	.vb	.hi	
forsake	.vb	.hi	
fort	.nn	.int	
forth	.av	.int	
forthcoming	.aj	.hi	
fortify	.vb	.hi	
fortnight	.nn	.hi	
fortunate	.aj	.int	
fortunately	.av	.int	
fortune	.nn	.int	
forty	.nu/.pn/.nn/.aj	.elem	
forum	.nn	.hi	
forward	.av/.aj	.elem	adv.= forwards（British English）
fossil	.nn/.aj	.hi	
foster	.aj/.vb	.hi	
foul	.aj/.vb/.nn	.hi	
found	.vb	.int	
foundation	.nn	.int	
founder	.nn	.int	
fountain	.nn	.int	
four	.nu/.pn/.nn/.aj	.elem	
fourteen	.nu/.pn/.nn/.aj	.elem	
fowl	.nn	.hi	
fox	.nn	.elem	
fraction	.nn	.hi	
fracture	.nn/.vb	.hi	
fragile	.aj	.hi	
fragment	.nn/.vb	.hi	
fragrance	.nn	.int	
fragrant	.aj	.hi	
frail	.aj	.hi	
frame	.vb/.nn	.int	
framework	.nn	.hi	
Franc	.nn	.hi	
France	.nn	.elem	
franchise	.nn/.vb	.hi	
frank	.aj	.elem	
frankly	.av	.hi	
frantic	.aj	.hi	
fraud	.nn	.hi	
freak	.aj/.nn	.hi	
freak	.vb	.hi	
free	.aj/.vb	.elem	
freedom	.nn	.elem	
freeway	.nn	.int	= motorway (British English)
freeze	.vb	.int	
freezer	.nn	.elem	
freezing	.aj/.nn	.int	
French	.aj/.nn	.elem	
frequency	.nn	.int	
frequent	.aj/.vb	.int	
fresh	.aj	.elem	
freshman	.nn	.int	
fret	.vb	.hi	
friction	.nn	.hi	
Friday	.nn	.elem	= Fri.
fridge	.nn	.int	= refrigerator
friend	.nn	.elem	
friendly	.aj	.elem	
friendship	.nn	.elem	
fright	.nn	.int	
frighten	.vb	.elem	
frightened	.aj	.int	
frightening	.aj	.int	
fringe	.nn/.aj/.vb	.hi	
frisbee	.nn	.elem	
frog	.nn	.elem	
from	.pr	.elem	
front	.nn/.aj	.elem	
frontier	.nn	.hi	
front-page	.aj	.hi	
frost	.nn/.vb	.int	
frosty	.aj	.int	
frown	.vb/.nn	.int	
frozen	.aj	.int	
fruit	.nn	.elem	
fruitful	.aj	.hi	
frustrate	.vb	.int	
frustration	.nn	.hi	
fry	.vb/.nn	.elem	
fuel	.nn/.vb	.int	
fulfill	.vb	.int	= fulfil (British English)
full	.aj	.elem	
full-time	.aj/.av	.hi	
fully	.av	.int	
fume	.vb	.hi	
fumes	.nn	.hi	
fun	.nn/.aj	.elem	
function	.nn/.vb	.elem	
functional	.aj	.int	
fund	.nn/.vb	.int	
fundamental	.aj	.int	
fundamentalism	.nn	.hi	
fundamentalist	.nn/.aj	.hi	
funding	.nn	.hi	
funeral	.nn	.int	
funny	.aj	.elem	
fur	.nn	.int	
furious	.aj	.int	
furnace	.nn	.hi	
furnish	.vb	.int	
furnished	.aj	.int	
furniture	.nn	.elem	
further	.av/.aj	.elem	
furthermore	.av	.int	
fury	.nn	.hi	
fuse	.nn/.vb	.hi	
fusion	.nn	.hi	
fuss	.nn/.vb	.hi	
future	.nn/.aj	.elem	
gain	.vb/.nn	.elem	
galaxy	.nn	.hi	
gallery	.nn	.int	
gallon	.nn	.int	
gallop	.nn/.vb	.hi	
gamble	.vb/.nn	.int	
gambler	.nn	.int	
gambling	.nn	.int	
game	.nn	.elem	
gang	.nn/.vb	.int	
gangster	.nn	.int	
gap	.nn	.int	
garage	.nn	.elem	
garbage	.nn	.elem	
garden	.nn	.elem	
gardener	.nn	.int	
garlic	.nn	.int	
garment	.nn	.hi	
gas	.nn	.elem	
gaseous	.aj	.hi	
gasoline	.nn	.elem	= gas= petrol
gasp	.nn/.vb	.hi	
gate	.nn	.elem	
gather	.vb	.elem	
gathering	.nn/.aj	.hi	
gauge	.vb/.nn	.hi	
gay	.aj	.int	
gaze	.vb/.nn	.int	
gear	.nn/.vb	.int	
gel	.vb/.nn	.hi	
gender	.nn	.hi	
gene	.nn	.int	
general	.aj	.elem	普遍的
general	.nn	.elem	將軍
generalize	.vb	.hi	
generally	.av	.int	
generate	.vb	.hi	
generation	.nn	.elem	
generator	.nn	.hi	
generosity	.nn	.int	
generous	.aj	.elem	
genetic	.aj	.hi	
genetics	.nn	.hi	
genius	.nn	.elem	
genre	.nn	.hi	
gentle	.aj	.elem	
gentleman	.nn	.elem	
genuine	.aj	.int	
geographical	.aj	.hi	= geographic
geography	.nn	.elem	
geology	.nn	.hi	
geometry	.nn	.hi	
germ	.nn	.int	
German	.aj/.nn	.elem	
Germany	.nn	.elem	
gesture	.nn/.vb	.elem	
get	.vb	.elem	
ghetto	.nn	.hi	
ghost	.nn	.elem	
giant	.aj/.nn	.elem	
gift	.nn	.elem	
gifted	.aj	.int	
gigantic	.aj	.int	
giggle	.vb/.nn	.int	
gilt	.aj/.nn	.hi	
ginger	.nn	.int	
giraffe	.nn	.int	
girl	.nn	.elem	
girlfriend	.nn	.int	
give	.vb	.elem	
given	.aj/.pr	.hi	
glacier	.nn	.hi	
glad	.aj	.elem	
glamor	.nn	.hi	= glamour (British English) 
glamorous	.aj	.hi	
glance	.vb/.nn	.int	
gland	.nn	.hi	
glare	.vb/.nn	.hi	
glass	.nn	.elem	
glasses	.nn	.int	
glassware	.nn	.hi	
gleam	.vb/.nn	.hi	
glee	.nn	.hi	
glide	.vb/.nn	.int	
glimpse	.nn/.vb	.int	
glisten	.vb	.hi	
glitter	.vb/.nn	.hi	
global	.aj	.int	
globe	.nn	.int	
gloom	.nn	.hi	
gloomy	.aj	.hi	
glorious	.aj	.int	
glory	.nn/.vb	.int	
glove	.nn	.elem	
glow	.vb/.nn	.int	
glue	.nn/.vb	.elem	
GMO	.nn	.hi	= genetically modified organism
gnaw	.vb	.hi	
go	.vb/.nn	.elem	
go-ahead	.nn/.aj	.hi	
goal	.nn	.elem	
goalkeeper	.nn	.hi	
goat	.nn	.elem	
gobble	.vb	.hi	
God	.nn	.elem	
goddess	.nn	.int	
going	.nn/.aj	.hi	
gold	.nn	.elem	
golden	.aj	.elem	
golf	.nn	.elem	
good	.aj/.nn	.elem	
good-bye	.nn	.elem	= goodbye, bye
good-looking	.aj	.hi	
goodness	.nn	.int	
goods	.nn	.int	
goodwill	.nn	.hi	
goose	.nn	.elem	
gore	.vb/.nn	.hi	
gorge	.nn	.hi	
gorge	.vb	.hi	
gorgeous	.aj	.hi	
gorilla	.nn	.hi	
gospel	.nn	.hi	
gossip	.nn/.vb	.int	
govern	.vb	.int	
government	.nn	.elem	
governmental	.aj	.hi	
governor	.nn	.int	
gown	.nn	.int	
grab	.vb/.nn	.int	
grace	.nn/.vb	.int	
graceful	.aj	.int	
gracious	.aj	.int	
grade	.nn	.elem	
gradual	.aj	.int	
gradually	.av	.int	
graduate	.nn/.vb	.int	
graduation	.nn	.int	
grain	.nn	.int	
gram	.nn	.elem	= gramme (British English)= g= gm
grammar	.nn	.int	
grammatical	.aj	.hi	
grand	.aj	.elem	
grandchild	.nn	.int	
granddaughter	.nn	.elem	
grandfather	.nn	.elem	= grandpa
grandmother	.nn	.elem	= grandma
grandparent	.nn	.int	
grandson	.nn	.elem	
grant	.vb/.nn	.int	
grape	.nn	.elem	
grapefruit	.nn	.int	
graph	.nn	.hi	
graphic	.aj	.hi	
grasp	.vb/.nn	.int	
grass	.nn	.elem	
grasshopper	.nn	.hi	
grassy	.aj	.hi	
grate	.nn	.hi	
grate	.vb	.hi	
grateful	.aj	.int	
gratitude	.nn	.int	
grave	.nn	.int	墳墓
grave	.aj	.int	嚴肅的
gravity	.nn	.int	
gray	.aj/.nn	.elem	= grey
graze	.vb/.nn	.hi	
grease	.nn/.vb	.hi	
greasy	.aj	.int	
great	.aj	.elem	
greatly	.av	.int	
greed	.nn	.hi	
greedy	.aj	.elem	
green	.aj/.nn	.elem	
greenhouse	.nn	.int	
greet	.vb	.elem	
greeting	.nn	.int	
grief	.nn	.int	
grieve	.vb	.int	
grill	.nn/.vb	.hi	
grim	.aj	.hi	
grin	.vb/.nn	.int	
grind	.vb/.nn	.int	
grip	.vb/.nn	.hi	
groan	.vb/.nn	.hi	
grocer	.nn	.hi	
grocery	.nn	.int	
groove	.nn	.hi	
grope	.vb/.nn	.hi	
gross	.aj/.vb/.nn	.hi	
ground	.nn	.elem	
group	.nn	.elem	
grove	.nn	.hi	
grow	.vb	.elem	
growl	.vb/.nn	.hi	
grown-up	.nn	.int	
growth	.nn	.elem	
grumble	.vb/.nn	.hi	
guarantee	.vb/.nn	.int	
guaranteed	.aj	.hi	
guard	.nn/.vb	.elem	
guardian	.nn	.int	
guava	.nn	.elem	
guerrilla	.nn	.hi	= guerilla
guess	.vb/.nn	.elem	
guest	.nn	.elem	
guidance	.nn	.int	
guide	.nn/.vb	.elem	
guideline	.nn	.hi	
guild	.nn	.hi	
guilt	.nn	.int	
guilty	.aj	.int	
guitar	.nn	.elem	
guitarist	.nn	.hi	
gulf	.nn	.int	
gulp	.vb/.nn	.hi	
gum	.nn	.int	
gun	.nn	.elem	
gunman	.nn	.hi	
gust	.nn/.vb	.hi	
gut	.nn/.vb/.aj	.hi	
guy	.nn	.elem	
gym	.nn	.elem	
gymnasium	.nn	.hi	= gym
gypsy	.nn/.aj	.hi	
habit	.nn	.elem	
habitat	.nn	.hi	
habitual	.aj	.int	
hack	.nn	.hi	
hack	.vb	.hi	
hacker	.nn	.hi	
hail	.vb/.nn	.hi	
hair	.nn	.elem	
haircut	.nn	.elem	
hairdresser	.nn	.int	
hairstyle	.nn	.hi	
half	.pn/.aj/.nn/.av	.elem	
half-time	.nn	.hi	
halfway	.av	.int	
hall	.nn	.elem	
Halloween	.nn	.elem	
hallway	.nn	.int	
halt	.vb/.nn	.int	
halve	.vb	.hi	
ham	.nn	.elem	
hamburger	.nn	.elem	= burger
hammer	.nn	.elem	
hamper	.nn	.hi	
hamper	.vb	.hi	
hand	.nn	.elem	手
hand	.vb	.elem	遞交
handbag	.nn	.int	
handbook	.nn	.hi	
handful	.nn	.int	
handicap	.nn/.vb	.int	
handicapped	.aj	.int	
handicraft	.nn	.hi	
handkerchief	.nn	.elem	
handle	.vb	.elem	處理
handle	.nn	.elem	把手
handsome	.aj	.elem	
handwriting	.nn	.int	
handy	.aj	.int	
hang	.vb	.elem	
hanger	.nn	.elem	
happen	.vb	.elem	
happily	.av	.int	
happy	.aj	.elem	
harass	.vb	.hi	
harassment	.nn	.hi	
harbor	.nn/.vb	.int	
hard	.aj/.av	.elem	
harden	.vb	.int	
hardline	.aj	.hi	= hard-line
hardliner	.nn	.hi	
hardly	.av	.elem	
hardship	.nn	.int	
hardware	.nn	.int	
hardwood	.nn	.hi	
hard-working	.aj	.int	
hardy	.aj	.hi	
harm	.nn/.vb	.int	
harmful	.aj	.int	
harmless	.aj	.hi	
harmonica	.nn	.hi	
harmony	.nn	.int	
harness	.vb/.nn	.hi	
harsh	.aj	.int	
harvest	.nn/.vb	.int	
hassle	.nn/.vb	.int	
haste	.nn	.hi	
hasten	.vb	.hi	
hasty	.aj	.int	
hat	.nn	.elem	
hatch	.vb/.nn	.int	
hate	.vb/.nn	.elem	
hateful	.aj	.hi	
hatred	.nn	.int	
haul	.nn	.hi	
haul	.vb	.hi	
haunt	.nn	.hi	
haunt	.vb	.hi	
have	.vb	.elem	
have	aux.	.elem	
haven	.nn	.hi	
hawk	.nn	.int	
hay	.nn	.int	
hazard	.nn/.vb	.hi	
hazardous	.aj	.hi	
he	.pn	.elem	
head	.nn/.vb	.elem	
headache	.nn	.elem	
heading	.nn	.hi	
headline	.nn/.vb	.int	
headmaster	.nn	.int	
head-on	.av/.aj	.hi	
headphones	.nn	.int	
headqu.arers	.nn	.int	
headsets		.int	
heal	.vb	.int	
health	.nn	.elem	
healthful	.aj	.hi	
healthy	.aj	.elem	
heap	.nn/.vb	.int	
hear	.vb	.elem	
hearing	.nn	.hi	
he.ar	.nn	.elem	
he.arbreak	.nn	.int	
he.ary	.aj	.hi	
heat	.nn/.vb	.elem	
heated	.aj	.hi	
heater	.nn	.elem	
heating	.nn	.hi	
heave	.vb/.nn	.hi	
heaven	.nn	.int	
heavenly	.aj	.int	
heavy	.aj	.elem	
heavyweight	.nn	.hi	
hedge	.nn/.vb	.hi	
heed	.vb/.nn	.hi	
heel	.nn	.int	
height	.nn	.elem	
heighten	.vb	.hi	
heir	.nn	.hi	
helicopter	.nn	.elem	
hell	.nn	.int	
hello	.nn/.in	.elem	
helmet	.nn	.int	
help	.vb/.nn	.elem	
helpful	.aj	.elem	
helpless	.aj	.hi	
hemisphere	.nn	.hi	
hen	.nn	.elem	
hence	.av	.int	
henceforth	.av	.hi	
her	.de	.elem	
herald	.vb/.nn	.hi	
herb	.nn	.hi	
herd	.nn/.vb	.int	
here	.av	.elem	
hereafter	.av/.nn	.hi	
heritage	.nn	.hi	
hermit	.nn	.hi	
hero	.nn	.elem	
heroic	.aj	.hi	
heroin	.nn	.hi	
heroine	.nn	.int	
hers	.pn	.elem	
herself	.pn	.elem	
hesitate	.vb	.int	
hesitation	.nn	.int	
heterosexual	.aj/.nn	.hi	
hey	.in	.elem	
hi	.in	.elem	
hidden	.aj	.int	
hide	.vb	.elem	
hierarchy	.nn	.hi	
hi-fi	.nn	.hi	= high fidelity
.hi	.aj/.av	.elem	
highlight	.vb/.nn	.hi	
highly	.av	.int	
high-rise	.nn	.int	
highway	.nn	.elem	
hijack	.vb	.int	
hijacker	.nn	.int	
hijacking	.nn	.int	
hike	.nn/.vb	.elem	
hiker	.nn	.int	
hiking	.nn	.int	
hill	.nn	.elem	
hillside	.nn	.hi	
him	.pn	.elem	
himself	.pn	.elem	
hinder	.vb	.hi	
hinge	.nn	.hi	
hinge	.vb	.hi	
hint	.nn/.vb	.int	
hip	.nn	.elem	
hippopotamus	.nn	.elem	= hippo
hire	.vb/.nn	.elem	
his	.de	.elem	
hiss	.vb/.nn	.hi	
historian	.nn	.int	
historic	.aj	.int	
historical	.aj	.int	
history	.nn	.elem	
hit	.vb/.nn	.elem	
hive	.nn	.int	
hoarse	.aj	.hi	
hobby	.nn	.elem	
hockey	.nn	.hi	
hold	.vb/.nn	.elem	
holder	.nn	.hi	
holding	.nn/.aj	.hi	
hole	.nn	.elem	
holiday	.nn	.elem	
hollow	.aj/.nn	.int	
holy	.aj	.int	
home	.nn/.av/.aj	.elem	
homeland	.nn	.int	
homeless	.aj/.nn	.hi	
homesick	.aj	.elem	
hometown	.nn	.hi	
homework	.nn	.elem	
homogeneous	.aj	.hi	= homogenous
homosexual	.aj/.nn	.hi	
honest	.aj	.elem	
honestly	.av	.int	
honesty	.nn	.elem	
honey	.nn	.elem	
honeymoon	.nn/.vb	.int	
Hong Kong	.nn	.elem	
honk	.nn/.vb	.hi	
honor	.nn/.vb	.int	= honour (British English)
honorable	.aj	.int	
honorary	.aj	.hi	
hood	.nn/.vb	.hi	
hoof	.nn	.hi	
hook	.nn/.vb	.int	
hop	.vb/.nn	.elem	
hope	.vb/.nn	.elem	
hopeful	.aj	.int	
hopefully	.av	.int	
hopeless	.aj	.hi	
horizon	.nn	.int	
horizontal	.aj/.nn	.hi	
hormone	.nn	.hi	
horn	.nn	.int	
horrible	.aj	.elem	
horrify	.vb	.int	
horror	.nn	.int	
horse	.nn	.elem	
horsepower	.nn	.hi	
hose	.nn/.vb	.int	
hospitable	.aj	.hi	
hospital	.nn	.elem	
hospitality	.nn	.hi	
hospitalize	.vb	.hi	
host	.nn/.vb	.elem	
hostage	.nn	.int	
hostel	.nn	.int	
hostess	.nn	.int	
hostile	.aj	.hi	
hostility	.nn	.hi	
hot	.aj	.elem	
hotel	.nn	.elem	
hound	.nn	.hi	
hound	.vb	.hi	
hour	.nn	.elem	
hourly	.aj/.av	.int	
house	.nn/.vb	.elem	
household	.nn/.aj	.int	
housekeeper	.nn	.int	
housewife	.nn	.int	
housework	.nn	.int	
housing	.nn	.int	
hover	.vb	.hi	
how	.av/.cj	.elem	
however	.av/.cj	.elem	
howl	.vb/.nn	.hi	
Hualian	.nn	.elem	
hug	.vb/.nn	.int	
huge	.aj	.elem	
hull	.nn	.hi	
hull	.vb	.hi	
hum	.vb/.nn	.int	
human	.aj/.nn	.elem	
humanitarian	.aj/.nn	.hi	
humanity	.nn	.int	
humble	.aj	.elem	
humid	.aj	.elem	
humidity	.nn	.int	
humiliate	.vb	.hi	
humiliation	.nn	.hi	
humor	.nn	.elem	= humour (British English)  
humorous	.aj	.elem	
hunch	.nn	.hi	
hunch	.vb	.hi	
hundred	.nu/.nn/.pn	.elem	
hunger	.nn	.elem	
hungry	.aj	.elem	
hunt	.vb/.nn	.elem	
hunter	.nn	.elem	
hurdle	.nn/.vb	.hi	
hurl	.vb	.hi	
hurricane	.nn	.int	
hurry	.vb/.nn	.elem	
hurt	.vb	.elem	
husband	.nn	.elem	
hush	.vb/.nn	.int	
hut	.nn	.int	
hybrid	.nn/.aj	.hi	
hydrogen	.nn	.int	
hygiene	.nn	.hi	
hymn	.nn/.vb	.hi	
hypocrisy	.nn	.hi	
hypocrite	.nn	.hi	
hypothesis	.nn	.hi	
hysterical	.aj	.hi	
I	.pn	.elem	
ice	.nn	.elem	
iceberg	.nn	.int	
icy	.aj	.int	
idea	.nn	.elem	
ideal	.aj/.nn	.int	
ideally	.av	.hi	
identical	.aj	.int	
identification	.nn	.int	
identify	.vb	.int	
identity	.nn	.int	
ideological	.aj	.hi	
ideology	.nn	.hi	
idiom	.nn	.int	
idiot	.nn	.hi	
idle	.aj/.vb	.int	
idol	.nn	.int	
if	.cj	.elem	
ignite	.vb	.hi	
ignorance	.nn	.int	
ignorant	.aj	.int	
ignore	.vb	.elem	
ill	.aj	.elem	
illegal	.aj	.int	
illness	.nn	.int	
illuminate	.vb	.hi	
illusion	.nn	.hi	
illustrate	.vb	.int	
illustration	.nn	.int	
image	.nn	.elem	
imaginable	.aj	.int	
imaginary	.aj	.int	
imagination	.nn	.int	
imaginative	.aj	.int	
imagine	.vb	.elem	
imitate	.vb	.int	
imitation	.nn	.int	
immediate	.aj	.int	
immediately	.av	.int	
immense	.aj	.hi	
immerse	.vb	.hi	
immigrant	.nn	.int	
immigrate	.vb	.hi	
immigration	.nn	.int	
imminent	.aj	.hi	
immune	.aj	.hi	
impact	.nn/.vb	.int	
impair	.vb	.hi	
imp.ar	.vb	.hi	
impatient	.aj	.int	
imperative	.aj/.nn	.hi	
imperial	.aj	.int	
impersonal	.aj	.int	
impetus	.nn	.hi	
implement	.vb	.int	
implication	.nn	.int	
implicit	.aj	.hi	
imply	.vb	.int	
impolite	.aj	.elem	
import	.nn/.vb	.elem	
importance	.nn	.elem	
important	.aj	.elem	
impose	.vb	.int	
imposing	.aj	.hi	
impossible	.aj	.elem	
impress	.vb	.int	
impression	.nn	.int	
impressive	.aj	.int	
imprison	.vb	.hi	
imprisonment	.nn	.hi	
improve	.vb	.elem	
improvement	.nn	.int	
impulse	.nn/.aj	.hi	
impulsive	.aj	.hi	
in	.pr/.av/.aj	.elem	
inability	.nn	.hi	
inaccessible	.aj	.hi	
inadequate	.aj	.int	
inappropriate	.aj	.hi	
inaugurate	.vb	.hi	
incense	.nn	.hi	
incense	.vb	.hi	
incentive	.nn	.hi	
inch	.nn	.elem	
incidence	.nn	.hi	
incident	.nn	.int	
incidental	.aj	.hi	
incidentally	.av	.hi	
incline	.vb/.nn	.hi	
inclined	.aj	.hi	
include	.vb	.elem	
included	.aj	.int	
including	.pr	.elem	
inclusive	.aj/.av	.hi	
income	.nn	.elem	
incomplete	.aj	.int	
inconvenient	.aj	.int	
incorporate	.vb	.hi	
increase	.vb/.nn	.elem	
increasingly	.av	.int	
incredible	.aj	.hi	
incumbent	.nn/.aj	.hi	
incur	.vb	.hi	
indeed	.av	.int	
indefinite	.aj	.hi	
independence	.nn	.int	
independent	.aj	.elem	
index	.nn/.vb	.hi	
India	.nn	.int	
Indian	.aj/.nn	.int	
indicate	.vb	.elem	
indication	.nn	.int	
indicative	.aj/.nn	.hi	
indicator	.nn	.hi	
indictment	.nn	.hi	
indifference	.nn	.hi	
indifferent	.aj	.hi	
indignant	.aj	.hi	
indignation	.nn	.hi	
indirect	.aj	.hi	
indispensable	.aj	.hi	
individual	.aj/.nn	.elem	
indoor	.aj	.int	
indoors	.av	.int	
induce	.vb	.hi	
indulge	.vb	.hi	
industrial	.aj	.int	
industrialize	.vb	.int	
industrialized	.aj	.hi	
industry	.nn	.elem	
inefficient	.aj	.hi	
inertia	.nn	.hi	
inevitable	.aj	.int	
inevitably	.av	.hi	
infant	.nn	.int	
infantry	.nn	.hi	
infect	.vb	.int	
infection	.nn	.int	
infectious	.aj	.hi	
infer	.vb	.int	
inference		.int	
inferior	.aj/.nn	.int	
infinite	.aj	.hi	
inflation	.nn	.int	
inflict	.vb	.hi	
influence	.nn/.vb	.elem	
influential	.aj	.int	
inform	.vb	.int	
informal	.aj	.int	
information	.nn	.elem	
informative	.aj	.int	
informed	.aj	.int	
infrastructure	.nn	.hi	
ingenious	.aj	.hi	
ingenuity	.nn	.hi	
ingredient	.nn	.int	
inhabit	.vb	.hi	
inhabitant	.nn	.int	
inherent	.aj	.hi	
inherit	.vb	.int	
inhibit	.vb	.hi	
inhibited	.aj	.hi	
inhibition	.nn	.hi	
initial	.aj/.nn/.vb	.int	
initially	.av	.hi	
initiate	.vb/.nn	.hi	
initiative	.nn	.hi	
inject	.vb	.int	
injection	.nn	.int	
injure	.vb	.int	
injured	.aj	.int	
injury	.nn	.elem	
injustice	.nn	.hi	
ink	.nn	.elem	
inland	.aj/.av	.hi	
inlet	.nn	.hi	
inmate	.nn	.hi	
inn	.nn	.int	
inner	.aj	.int	
inning	.nn	.hi	
innocence	.nn	.int	
innocent	.aj	.int	
innovation	.nn	.hi	
innovative	.aj	.hi	
innumerable	.aj	.hi	
input	.nn/.vb	.int	
inquire	.vb	.int	= enquire
inquiry	.nn	.int	= enquiry
insane	.aj	.hi	
insect	.nn	.elem	
insecticide	.nn	.hi	
insecure	.aj	.hi	
insert	.vb	.int	
inside	.pr/.av/.nn	.elem	
insider	.nn	.hi	
insight	.nn	.hi	
insist	.vb	.elem	
insistence	.nn	.hi	
insistent	.aj	.hi	
inspect	.vb	.int	
inspection	.nn	.hi	
inspector	.nn	.int	
inspiration	.nn	.int	
inspire	.vb	.elem	
instability	.nn	.hi	
install	.vb	.int	
installation	.nn	.hi	
installment	.nn	.hi	= instalment (British English)
instance	.nn	.elem	
instant	.aj/.nn	.elem	
instantaneous	.aj	.hi	
instead	.av	.int	
instinct	.nn	.int	
instinctive	.aj	.hi	
institute	.nn	.int	
institution	.nn	.int	
institutional	.aj	.hi	
instruct	.vb	.int	
instruction	.nn	.int	
instructor	.nn	.int	
instrument	.nn	.elem	
instrumental	.aj	.hi	
insufficient	.aj	.hi	
insulate	.vb	.hi	
insult	.nn/.vb	.int	
insurance	.nn	.int	
insure	.vb	.hi	
insurer	.nn	.hi	
intact	.aj	.hi	
intake	.nn	.hi	
integral	.aj	.hi	
integrate	.vb	.hi	
integration	.nn	.hi	
integrity	.nn	.hi	
intellect	.nn	.hi	
intellectual	.aj/.nn	.int	
intelligence	.nn	.int	
intelligent	.aj	.elem	
intelligible	.aj	.hi	
intend	.vb	.int	
intense	.aj	.int	
intensify	.vb	.int	
intensity	.nn	.hi	
intensive	.aj	.int	
intent	.aj/.nn	.hi	
intention	.nn	.int	
inter	.vb	.hi	
interact	.vb	.int	
interaction	.nn	.hi	
intercourse	.nn	.hi	
interest	.nn/.vb	.elem	
interested	.aj	.elem	
interesting	.aj	.int	
interfere	.vb	.int	
interference	.nn	.int	
interim	.aj/.nn	.hi	
interior	.nn/.aj	.hi	
intermediate	.aj	.int	
intermittent	.aj	.hi	
internal	.aj	.int	
international	.aj	.elem	
Internet	.nn	.elem	
interpret	.vb	.int	
interpretation	.nn	.int	
interpreter	.nn	.int	
interrupt	.vb	.elem	
interruption	.nn	.hi	
intersection	.nn	.hi	
interval	.nn	.int	
intervene	.vb	.hi	
intervention	.nn	.hi	
interview	.nn/.vb	.elem	
intimacy	.nn	.hi	
intimate	.aj/.nn	.int	
intimidate	.vb	.hi	
into	.pr	.elem	
intonation	.nn	.hi	
intricate	.aj	.hi	
intrigue	.nn	.hi	
intrigue	.vb	.hi	
intriguing	.aj	.hi	
intrinsic	.aj	.hi	
introduce	.vb	.elem	
introduction	.nn	.int	
intrude	.vb	.int	
intruder	.nn	.int	
intrusion	.nn	.hi	
intuition	.nn	.hi	
invade	.vb	.int	
invalid	.nn/.aj	.hi	
invaluable	.aj	.hi	
invariable	.aj	.hi	
invasion	.nn	.int	
invent	.vb	.elem	
invention	.nn	.int	
inventor	.nn	.int	
inventory	.nn	.hi	
invert	.vb	.hi	
invest	.vb	.int	
investigate	.vb	.elem	
investigation	.nn	.hi	
investigator	.nn	.hi	
investment	.nn	.int	
investor	.nn	.int	
invisible	.aj	.int	
invitation	.nn	.elem	
invite	.vb	.elem	
inviting	.aj	.hi	
involve	.vb	.int	
involved	.aj	.int	
involvement	.nn	.hi	
inward	.av	.hi	= inwards (British English)
IQ	.nn	.hi	= intelligence quotient
iron	.nn/.vb	.elem	
ironic	.aj	.hi	
ironically	.av	.hi	
irony	.nn	.hi	
irregular	.aj	.int	
irrelevant	.aj	.hi	
irresistible	.aj	.hi	
irrespective	.aj	.hi	
irrigation	.nn	.hi	
irritable	.aj	.hi	
irritate	.vb	.hi	
irritation	.nn	.hi	
is	.vb	.elem	
island	.nn	.elem	
isle	.nn	.hi	
isolate	.vb	.int	
isolated	.aj	.hi	
isolation	.nn	.int	
issue	.nn/.vb	.int	
it	.pn	.elem	
itch	.vb/.nn	.int	
item	.nn	.elem	
its	.de	.elem	
itself	.pn	.elem	
ivory	.nn/.aj	.int	
ivy	.nn	.hi	
jack	.nn	.hi	
jack	.vb	.hi	
jacket	.nn	.elem	
jade	.nn	.hi	
jail	.nn/.vb	.int	
jam	.vb	.int	擠滿;塞住
jam	.nn	.elem	果醬
janitor	.nn	.hi	
January	.nn	.elem	= Jan.
Japan	.nn	.elem	
Japanese	.aj/.nn	.elem	
jar	.nn	.int	
jasmine	.nn	.hi	
jaw	.nn/.vb	.int	
jaywalk	.vb	.hi	
jazz	.nn	.elem	
jealous	.aj	.elem	
jealousy	.nn	.int	
jeans	.nn	.elem	
jeep	.nn	.elem	
jeer	.vb/.nn	.hi	
jelly	.nn	.int	
jeopardize	.vb	.hi	= jeopardise (British English)
jerk	.vb/.nn	.hi	
jersey	.nn	.hi	
jet	.nn/.vb	.int	
jewel	.nn	.int	
jewellery	.nn	.int	
jingle	.vb/.nn	.hi	
job	.nn	.elem	
jobless	.aj	.hi	
jockey	.nn	.hi	
jockey	.vb	.hi	
jog	.vb	.elem	
join	.vb	.elem	
joint	.aj/.nn	.elem	
joke	.nn/.vb	.elem	
journal	.nn	.int	
journalism	.nn	.hi	
journalist	.nn	.elem	
journey	.nn/.vb	.int	
joy	.nn	.elem	
joyful	.aj	.int	
joyous	.aj	.hi	
judge	.nn/.vb	.elem	法官;評審,判斷
judgment	.nn	.int	= judgement
judicial	.aj	.hi	
judiciary	.nn	.hi	
jug	.nn	.hi	
jug	.vb	.hi	
juice	.nn	.elem	
juicy	.aj	.int	
July	.nn	.elem	= Jul.
jump	.vb/.nn	.elem	
jumper	.nn	.hi	
junction	.nn	.hi	
June	.nn	.elem	= Jun.
jungle	.nn	.int	
junior	.aj/.nn	.int	
junk	.nn	.int	
jury	.nn	.int	
just	.av	.elem	只,僅
justice	.nn	.int	
justification	.nn	.hi	
justified	.aj	.hi	
justify	.vb	.hi	
juvenile	.nn/.aj	.hi	
kangaroo	.nn	.elem	
Kaohsiung	.nn	.elem	
keen	.aj	.int	
keep	.vb	.elem	
keeper	.nn	.int	
kernel	.nn	.hi	
ketchup	.nn	.elem	= catsup
kettle	.nn	.int	
key	.nn	.elem	鑰匙
key	.aj	.elem	重要的
keyboard	.nn	.int	
kick	.vb/.nn	.elem	
kid	.nn	.elem	
kidnap	.vb	.int	
kidney	.nn	.int	
kill	.vb	.elem	
killer	.nn	.hi	
killing	.nn/.aj	.hi	
kilogram	.nn	.elem	= kg
kilometer	.nn	.elem	= kilometre (British English)=km
kin	.nn	.hi	
kind	.aj	.elem	仁慈的
kind	.nn	.elem	種類
kinderg.aren	.nn	.elem	
kindle	.vb	.hi	
kindly	.aj/adv	.int	
kindness	.nn	.int	
king	.nn	.elem	
kingdom	.nn	.elem	
kiss	.vb/.nn	.elem	
kit	.nn	.int	
kitchen	.nn	.elem	
kite	.nn	.elem	
kitten	.nn	.elem	= kitty
knee	.nn	.elem	
kneel	.vb	.int	
knife	.nn	.elem	
knight	.nn	.int	
knit	.vb/.nn	.int	
knob	.nn	.int	
knock	.vb	.elem	
knot	.nn/.vb	.int	
know	.vb	.elem	
know-how	.nn	.hi	
knowledge	.nn	.elem	
knowledgeable	.aj	.int	
knuckle	.nn/.vb	.hi	
koala	.nn	.elem	
Korea	.nn	.elem	
Korean	.aj/.nn	.elem	
KTV	.nn	.elem	
label	.nn/.vb	.int	
labor	.nn/.vb	.int	= labour (British English)
laboratory	.nn	.int	= lab
lace	.nn/.vb	.int	
lack	.nn/.vb	.elem	
lad	.nn	.hi	
ladder	.nn	.int	
lady	.nn	.elem	
ladybug	.nn	.int	= ladybird (British English)
lag	.vb/.nn	.int	
lake	.nn	.elem	
lamb	.nn	.elem	
lame	.aj	.hi	
lament	.nn/.vb	.hi	
lamp	.nn	.elem	
land	.nn/.vb	.elem	
landing	.nn	.hi	
landlady	.nn	.int	
landlord	.nn	.int	
landmark	.nn	.int	
landscape	.nn/.vb	.int	
landslide	.nn	.int	
lane	.nn	.int	
language	.nn	.elem	
lantern	.nn	.int	
Lantern Festival	.nn	.elem	
lap	.nn	.int	
large	.aj	.elem	
largely	.av	.int	
large-scale	.aj	.hi	
laser	.nn	.int	
lash	.nn/.vb	.hi	
last	.vb	.int	持續
last 	.aj/.pn/.nn	.elem	最後的,剛過去的
lasting	.aj	.hi	
late	.aj/.av	.elem	
lately	.av	.int	
latent	.aj	.hi	
later	.av	.elem	
latest	.aj	.elem	
latitude	.nn	.int	
latter	.aj	.int	
laugh	.vb/.nn	.elem	
laughter	.nn	.int	
launch	.vb/.nn	.int	
laundry	.nn	.int	
lava	.nn	.hi	
lavatory	.nn	.int	= toilet
lavish	.aj/.vb	.hi	
law	.nn	.elem	
lawful	.aj	.int	
lawmaker	.nn	.hi	
lawn	.nn	.int	
lawsuit	.nn	.hi	
lawyer	.nn	.elem	
lay	.vb	.elem	
layer	.nn	.int	
layman	.nn	.hi	
layout	.nn	.hi	
lazy	.aj	.elem	
LCD	.nn	.hi	= liquid crystal display
lead	.nn	.int	鉛
lead 	.vb/.nn	.elem	帶領,引導
leader	.nn	.elem	
leadership	.nn	.elem	
lead-in	.nn	.hi	
leading	.aj	.int	
leaf	.nn	.elem	
leaflet	.nn	.int	
league	.nn	.int	
leak	.vb/.nn	.int	
lean	.vb/.aj	.int	
leap	.vb/.nn	.int	
learn	.vb	.elem	
learned	.aj	.int	
learner	.nn	.int	
learning	.nn	.int	
lease	.nn/.vb	.hi	
least	.av/.aj/.pn/.nn	.elem	
leather	.nn	.int	
leave	.vb/.nn	.elem	
lecture	.nn/.vb	.int	
lecturer	.nn	.int	
lee	.nn/.aj	.hi	
left	.aj/.nn/.av	.elem	左邊（的）
left	.aj	.elem	剩下的
left-hand	.aj	.hi	
left-wing	.aj/.nn	.hi	
leg	.nn	.elem	
legacy	.nn	.hi	
legal	.aj	.elem	
legend	.nn	.int	
legendary	.aj	.int	
legislation	.nn	.hi	
legislative	.aj	.hi	
legislator	.nn	.hi	
legislature	.nn	.hi	
legitimate	.aj	.hi	
leisure	.nn/.aj	.int	
leisurely	.aj/.av	.int	
lemon	.nn	.elem	
lemonade	.nn	.int	
lend	.vb	.elem	
length	.nn	.elem	
lengthen	.vb	.int	
lengthy	.aj	.hi	
lens	.nn	.int	
leopard	.nn	.int	
lesbian	.aj/.nn	.hi	
less	.av/.pn	.elem	
lessen	.vb	.hi	
lesser	.aj	.hi	
lesson	.nn	.elem	
lest	.cj	.hi	
let	.vb	.elem	
lethal	.aj	.hi	
letter	.nn	.elem	
lettuce	.nn	.elem	
level	.nn/.aj	.elem	
lever	.nn/.vb	.hi	
levy	.nn/.vb	.hi	
liability	.nn	.hi	
liable	.aj	.hi	
liar	.nn	.int	
libel	.nn/.vb	.hi	
liberal	.aj/.nn	.int	
liberalize	.vb	.hi	
liberate	.vb	.int	
liberation	.nn	.hi	
liberty	.nn	.int	
librarian	.nn	.int	
library	.nn	.elem	
license	.vb/.nn	.int	= licence (British English)
lick	.vb/.nn	.elem	
lid	.nn	.elem	
lie 	.vb	.elem	躺下,橫臥,擺放
lie 	.nn/.vb	.elem	謊言,說謊
lieutenant	.nn	.hi	
life	.nn	.elem	
lifeboat	.nn	.hi	
lifeguard	.nn	.hi	
lifelong	.aj	.hi	
lifestyle	.nn	.hi	
lifetime	.nn	.int	
lift	.vb/.nn	.elem	
light 	.nn/.vb/.aj	.elem	光,點著,照亮
light 	.aj/.av	.elem	輕的
lighten	.vb	.int	
lighthouse	.nn	.int	
lighting	.nn	.hi	
lightning	.nn	.elem	
lightweight	.aj/.nn	.hi	
like	.pr	.elem	
like	.vb	.elem	
likelihood	.nn	.hi	
likely	.aj/.av	.elem	
likewise	.av	.hi	
lily	.nn	.int	
limb	.nn	.int	
lime	.nn	.hi	
limit	.vb/.nn	.elem	
limitation	.nn	.int	
limited	.aj	.hi	
limousine	.nn	.hi	= limo
limp	.vb/.nn	.hi	
limp	.aj	.hi	
line	.nn/.vb	.elem	
linear	.aj	.hi	
linen	.nn	.int	
liner	.nn	.hi	
line-up	.nn	.hi	= lineup (American English)
linger	.vb	.hi	
linguist	.nn	.hi	
lining	.nn	.hi	
link	.nn/.vb	.elem	
lion	.nn	.elem	
lip	.nn	.elem	
lipstick	.nn	.int	
liquid	.nn/.aj	.elem	
liquor	.nn	.int	= spirits (British English)
list	.nn/.vb	.elem	
listen	.vb	.elem	
listener	.nn	.int	
liter	.nn	.elem	= litre (British English)
literacy	.nn	.hi	
literal	.aj	.hi	
literally	.av	.hi	
literary	.aj	.int	
literate	.aj	.hi	
literature	.nn	.int	
litter	.nn/.vb	.int	noun= 垃圾
little	.aj/.pn/.av	.elem	
live	.aj	.int	活的;實況的
live 	.vb	.elem	生活,生存
live-in	.aj	.hi	
lively	.aj	.int	
liver	.nn	.int	
livestock	.nn	.hi	
living	.nn/.aj	.hi	
lizard	.nn	.hi	
llama	.nn	.hi	
load	.nn/.vb	.int	
loaded	.aj	.hi	
loaf	.nn	.elem	
loan	.nn/.vb	.int	
lobby	.nn	.int	
lobster	.nn	.int	
local	.aj/.nn	.elem	
locality	.nn	.hi	
locate	.vb	.int	
located	.aj	.hi	
location	.nn	.int	
lock	.vb/.nn	.elem	
locked	.aj	.hi	
locker	.nn	.int	
locomotive	.nn	.hi	noun = loco
locomotive	.aj	.hi	
locust	.nn	.hi	
lodge	.nn/.vb	.hi	
lofty	.aj	.hi	
log	.nn/.vb	.int	
logic	.nn	.int	
logical	.aj	.int	
logo	.nn	.hi	
lollipop	.nn	.hi	
London	.nn	.elem	
lone	.aj	.hi	
loneliness	.nn	.int	
lonely	.aj	.elem	
lonesome	.aj	.hi	
long	.vb	.int	期盼
long 	.aj/.av	.elem	長的
longevity	.nn	.hi	
longitude	.nn/.aj	.hi	
long-standing	.aj	.hi	
long-term	.aj	.int	
long-time	.aj	.hi	
look	.vb/.nn	.elem	
loom	.nn	.hi	
loom	.vb	.hi	
loop	.nn/.vb	.int	
loose	.aj	.int	
loosen	.vb	.int	
loot	.vb/.nn	.hi	
lord	.nn	.int	
lorry	.nn	.int	= truck (American English)
lose	.vb	.elem	
loser	.nn	.elem	
loss	.nn	.elem	
lost	.aj	.hi	
lot	.nn/.pn/.av	.elem	
lotion	.nn	.int	
lottery	.nn	.hi	
lotus	.nn	.hi	
loud	.aj/.av	.elem	
loudspeaker	.nn	.int	
lounge	.nn/.vb	.hi	
lousy	.aj	.int	
love	.vb/.nn	.elem	
lovely	.aj	.elem	
lover	.nn	.elem	
loving	.aj	.hi	
low	.aj	.elem	
lower	.vb	.int	
loyal	.aj	.int	
loyalty	.nn	.int	
lubricate	.vb	.hi	
luck	.nn	.int	
luckily	.av	.int	
lucky	.aj	.elem	
lucrative	.aj	.hi	
luggage	.nn	.int	
lullaby	.nn/.vb	.int	
lumber	.nn	.hi	
lumber	.vb	.hi	
luminous	.aj	.hi	
lump	.nn/.vb	.hi	
lunar	.aj	.int	
lunatic	.nn/.aj	.hi	
lunch	.nn	.elem	
lunchtime	.nn	.hi	
lung	.nn	.int	
lure	.vb/.nn	.hi	
lush	.aj	.hi	
luxurious	.aj	.int	
luxury	.nn	.int	
lychee	.nn	.int	= litchi 荔枝
lynch	.vb	.hi	
lyric	.aj/.nn	.hi	
ma'am	.nn	.elem	
machine	.nn	.elem	
machinery	.nn	.int	
mad	.aj	.elem	
madam	.nn	.int	
made-up	.aj	.hi	
mafia	.nn	.hi	
magazine	.nn	.elem	
magic	.aj/.nn.	.elem	
magical	.aj	.int	
magician	.nn	.elem	
magistrate	.nn	.hi	
magnet	.nn	.int	
magnetic	.aj	.int	
magnificent	.aj	.int	
magnify	.vb	.hi	
magnitude	.nn	.hi	
maid	.nn	.int	
maiden	.nn/.aj	.hi	
mail	.nn/.vb	.elem	
mailman	.nn	.elem	= postman (British English)= mail carrier
main	.aj	.elem	
mainland	.nn	.int	
mainly	.av	.int	
mainstream	.nn	.hi	
maintain	.vb	.elem	
maintenance	.nn	.hi	
majestic	.aj	.hi	
majesty	.nn	.hi	
major	.aj	.elem	
major	.nn	.elem	
major	.vb	.elem	
majority	.nn	.int	
make	.vb	.elem	
maker	.nn	.int	
make-up	.nn	.int	
making	.nn	.hi	
malaria	.nn	.hi	
male	.aj/.nn	.elem	
mall	.nn	.elem	
mammal	.nn	.hi	
man	.nn	.elem	
manage	.vb	.int	
manageable	.aj	.int	
management	.nn	.int	
manager	.nn	.elem	
Mandarin	.nn	.elem	
mandate	.nn/.vb	.hi	
maneuver	.vb/.nn	.hi	= manoeuvre (British English)
mango	.nn	.elem	
manifest	.aj/.vb	.hi	
manifest	.nn	.hi	貨物或乘客名單
manifesto	.nn	.hi	
manipulate	.vb	.hi	
mankind	.nn	.int	
man-made	.aj	.int	
manner	.nn	.elem	
mansion	.nn	.int	
manual	.nn/.aj	.int	
manufacture	.vb/.nn	.int	
manufacturer	.nn	.int	
manuscript	.nn	.hi	
many	.aj/.pn	.elem	
map	.nn	.elem	
maple	.nn	.hi	
mar	.vb	.hi	
marathon	.nn	.int	
marble	.nn	.int	
march	.vb/.nn	.int	
March	.nn	.elem	= Mar.
mare	.nn	.hi	
margin	.nn	.int	
marginal	.aj/.nn	.hi	
marine	.nn/.aj	.hi	
mark	.vb/.nn	.elem	
marked	.aj	.hi	
marker	.nn	.elem	
market	.nn/.vb	.elem	
marketing	.nn	.hi	
marriage	.nn	.elem	
married	.aj	.elem	
marry	.vb	.elem	
marsh	.nn	.hi	
marshal	.vb/.nn	.hi	
m.arial	.aj	.hi	
marvel	.nn/.vb	.hi	
marvelous	.aj	.elem	= marvellous (British English)
masculine	.aj	.hi	
mash	.nn/.vb	.hi	
mask	.nn	.elem	
mass	.nn/.aj	.elem	
massacre	.nn/.vb	.hi	
massage	.nn/.vb	.hi	
massive	.aj	.hi	
master	.nn	.elem	
masterpiece	.nn	.int	
mastery	.nn	.hi	
mat	.nn	.elem	
match	.nn/.vb	.elem	
mate	.nn/.vb	.int	
material	.nn	.elem	
materialism	.nn	.hi	
math 	.nn	.elem	= mathematics
mathematical	.aj	.int	
matter	.nn	.elem	
matter	.vb	.elem	
mattress	.nn	.hi	
mature	.aj	.int	
maturity	.nn	.int	
maximum	.aj/.nn/.av	.elem	
may	aux.	.elem	                                                                                                                                                                                                                                                                                                                                                                                                                                                                                                                                                                                                                                                                                                                                                                                                                                                                                                                                                                                                                                                                                                                                                                                                                                                                                                                                                                                                                                                                                                                                                                                                                                                                                                                                                                                                                                                                                                                                                                                                                                                                                                                                                                                                                                                                                                                                                                                                                                                                                                                                                                                                                                                                                                                                                                                                                                                                                                                                                                                                                                                                                                                                                                                                                                                                                                                                                                                                                                                                                                                                                                                                                                                                                                                                                                                                                                                                                                                                                                                                                                                                                                                                                                                                                                                                                                                                                                                                                                                                                                                                                                                                                                                                                                                                                                                                                                                                                                                                                                                                                                                                                                                                                                                                                                                                                                                                                                                                                                                                                                                                                                                                                                                                                                                                                                                                                                                                                                                                                                                                                                                                                                                                                                                                                                                                                                                                                                                                                                                                                                                                                                                                                                                                                                                                                                                                                                                                                                                                                                                                                                                                                                                                                                                                                                                                                                                                                                                                                                                                                                                                                                                                                                                                                                                                                                                                                                                                                                                                                                                                                                                                                                                                                                                                                                                                                                                                                                                                                                                                                                                                                                                                                                                                                                                                                                                                                                                                                                                                                                                                                                                                                                                                                                                                                                                                                                                                                                                                                                                                                                                                                                                                                                                                                                                                                                                                                                                                                                                                                                                                                                                                                                                                                                                                                                                                                                                                                                                                                                                                                                                                                                                                                                                                                                                                                                                                                                                                                                                                                                                                                                                                                                                                                                                                                                                                                                                                                                                                                                                                                                                                                                                                                                                                                                                                                                                                                                                                                                                                                                                                                                                                                                                                                                                                                                                                                                                                                                                                                                                                                                                                                                                                                                                                                                                                                                                                                                                                                                                                                                                                                                                                                                                                                                                                                                                                                                                                                                                                                                                                                                                                                                                                                                                                                                                                                                                                                                                                                                                                                                                                                                                                                                                                                                                                                                                                                                                                                                                                                                                                                                                                                                                                                                                                                                                                                                                                                                                                                                                                                                                                                                                                                                                                                                                                                                                                                                                                                                                                                                                                                                                                                                                                                                                                                                                                                                                                                                                                                                                                                                                                                                                                                                                                                                                                                                                                                                                                                                                                                                                                                                                                                                                                                                                                                                                                                                                                                                                                                                                                                                                                                                                                                                                                                                                                                                                                                                                                                                                                                                                                                                                                                                                                                                                                                                                                                                                                                                                                                                                                                                                                                                                                                                                                                                                                                                                                                                                                                                                                                                                                                                                                                                                                                                                                                                                                                                                                                                                                                                                                                                                                                                                                                                                                                                                                                                                                                                                                                                                                                                                                                                                                                                                                                                                                                                                                                                                                                                                                                                                                                                                                                                                                                                                                                                                                                                                                                                                                                                                                                                                                                                                                                                                                                                                                                                                                                                                                                                                                                                                                                                                                                                                                                                                                                                                                                                                                                                                                                                                                                                                                                                                                                                                                                                                                                                                                                                                                                                                                                                                                                                                                                                                                                                                                                                                                                                                                                                                                                                                                                                                                                                                                                                                                                                                                                                                                                                                                                                                                                                                                                                                                                                                                                                                                                                                                                                                                                                                                                                                                                                                                                                                                                                                                                                                
May	.nn	.elem	
maybe	.av	.elem	
mayonnaise	.nn	.hi	
mayor	.nn	.int	
me	.pn	.elem	
meadow	.nn	.int	
meal	.nn	.elem	
mean	.aj	.int	吝嗇的;低劣的
mean 	.vb	.elem	意指
meaning	.nn	.elem	
meaningful	.aj	.int	
means	.nn	.elem	
meantime	.nn	.int	
meanwhile	.av	.int	
measurable	.aj	.int	
measure	.nn/.vb	.elem	
measurement	.nn	.hi	
meat	.nn	.elem	
mechanic	.nn	.elem	
mechanical	.aj	.int	
mechanics	.nn	.hi	
mechanism	.nn	.hi	
medal	.nn	.int	
media	.nn	.hi	
mediate	.vb	.hi	
medical	.aj	.int	
medication	.nn	.hi	
medicine	.nn	.elem	
medieval	.aj	.hi	
meditate	.vb	.hi	
meditation	.nn	.hi	
medium	.nn/.aj	.elem	mediums/media (plural form)
meet	.vb	.elem	
meeting	.nn	.elem	
melancholy	.nn/.aj	.hi	
mellow	.aj/.vb	.hi	
melody	.nn	.int	
melon	.nn	.elem	
melt	.vb	.int	
member	.nn	.elem	
membership	.nn	.int	
memorable	.aj	.int	
memorandum	.nn	.int	
memorial	.nn/.aj	.int	
memorize	.vb	.int	
memory	.nn	.elem	
menace	.nn/.vb	.hi	
mend	.vb	.int	
mental	.aj	.int	
mentality	.nn	.hi	
mention	.vb/.nn	.int	
menu	.nn	.elem	
merchandise	.nn/.vb	.hi	
merchant	.nn	.int	
mercury	.nn	.hi	
mercy	.nn	.int	
mere	.aj	.int	
merely	.av	.hi	
merge	.vb	.hi	
merger	.nn	.hi	
merit	.nn	.int	
mermaid	.nn	.hi	
merry	.aj	.int	
mess	.nn/.vb	.int	
message	.nn	.elem	
messenger	.nn	.int	
messy	.aj	.int	
metal	.nn	.elem	
metallic	.aj	.hi	
metaphor	.nn	.hi	
meter	.vb	.int	
meter 	.nn	.elem	= metre (British English)= m
method	.nn	.elem	
metric	.aj	.hi	
metro	.nn	.int	= Metro
metropolitan	.aj/.nn	.hi	
microphone	.nn	.int	= mike
microscope	.nn	.int	
microwave	.nn/.vb	.elem	
midday	.nn	.int	
middle	.aj/.nn	.elem	
middle-aged	.aj	.hi	
midnight	.nn/.aj	.elem	
midst	.nn/.pr	.hi	
might	.nn	.int	力氣
might 	aux.	.elem	大概,可能
mighty	.aj	.int	
migrant	.nn	.hi	
migrate	.vb	.hi	
migration	.nn	.hi	
mild	.aj	.int	
mile	.nn	.elem	
mileage	.nn	.hi	
milestone	.nn	.hi	
militant	.aj/.nn	.hi	
military	.aj/.nn	.elem	
militia	.nn	.hi	
milk	.nn	.elem	
milkshake	.nn	.int	
mill	.nn/.vb	.int	
miller	.nn	.hi	
millimeter	.nn	.hi	= millimetre (British English), mm
million	.nu/.pn/.nn	.elem	
millionaire	.nn	.hi	
mimic	.vb/.nn	.hi	
mind	.nn/.vb	.elem	
mine	.nn	.int	礦,礦坑
mine 	.pn	.elem	我的
miner	.nn	.int	
mineral	.nn/.aj	.int	
mingle	.vb	.hi	
miniature	.aj/.nn	.hi	
minimal	.aj	.hi	
minimize	.vb	.hi	
minimum	.aj/.nn	.int	= min.
mining	.nn	.hi	
minister	.nn	.int	
ministerial	.aj	.hi	
ministry	.nn	.int	
minor	.aj	.elem	
minor	.nn	.elem	
minor	.vb	.elem	
minority	.nn	.int	
mint	.nn/.vb/.aj	.hi	鑄造
mint	.nn	.hi	薄荷
minus	.pn/.cj/.aj/.nn	.elem	
minute	.aj	.int	極細微的 (P)
minute	.nn	.elem	分 (P)；= min.
miracle	.nn	.int	
miraculous	.aj	.hi	
mirror	.nn	.elem	
miscarriage	.nn	.hi	
mischief	.nn	.int	
mischievous	.aj	.hi	
miser	.nn	.hi	
miserable	.aj	.int	
misery	.nn	.int	
misfortune	.nn	.int	
mislead	.vb	.int	
misleading	.aj	.int	
miss	.vb	.elem	
Miss	.nn	.elem	
missile	.nn	.int	
missing	.aj	.elem	
mission	.nn	.int	
missionary	.nn/.aj	.hi	
mist	.nn/.vb	.int	
mistake	.nn/.vb	.elem	
mistaken	.aj	.hi	
mister	.nn	.int	
mistress	.nn	.int	
misunderstand	.vb	.int	
mix	.vb/.nn	.elem	
mixed	.aj	.hi	
mixture	.nn	.int	
moan	.vb/.nn	.hi	
mob	.nn/.vb	.int	
mobile	.aj	.int	
mobilize	.vb	.hi	= mobilise (British English)
mock	.vb/.aj/.nn	.hi	
mode	.nn	.hi	
model	.nn/.vb	.elem	
moderate	.aj	.int	
modern	.aj	.elem	
modernization	.nn	.hi	
modernize	.vb	.hi	
modest	.aj	.int	
modesty	.nn	.int	
modify	.vb	.hi	
moist	.aj	.int	
moisture	.nn	.int	
mold	.nn/.vb	.hi	= mould (British English)
molecule	.nn	.hi	
moment	.nn	.elem	
momentum	.nn	.hi	
monarch	.nn	.hi	
monarchy	.nn	.hi	
Monday	.nn	.elem	= Mon.
monetary	.aj	.hi	
money	.nn	.elem	
monitor	.vb/.nn	.int	
monk	.nn	.int	
monkey	.nn	.elem	
monopoly	.nn	.hi	
monotonous	.aj	.hi	
monotony	.nn	.hi	
monster	.nn	.elem	
monstrous	.aj	.hi	
month	.nn	.elem	
monthly	.aj/.av/.nn	.elem	
monument	.nn	.int	
mood	.nn	.int	
moody	.aj	.hi	
moon	.nn	.elem	
moonlight	.nn	.int	
moor	.nn	.hi	
moor	.vb	.hi	
mop	.nn/.vb	.elem	
moral	.aj/.nn	.int	
morale	.nn	.hi	
morality	.nn	.hi	
more	.av/.pn/.aj	.elem	
moreover	.av	.int	
morning	.nn	.elem	
mortal	.nn	.hi	
mortal	.aj	.hi	
mortar	.nn	.hi	
mortar	.vb	.hi	
mortgage	.nn/.vb	.int	
mosque	.nn	.hi	
mosquito	.nn	.elem	
moss	.nn	.hi	
most	.av/.pn/.aj	.elem	
mostly	.av	.int	
motel	.nn	.int	
moth	.nn	.int	
mother	.nn/.vb	.elem	= mommy= mom= momma= mamma
motherhood	.nn	.hi	
Mother's Day	.nn	.elem	
motion	.nn/.vb	.elem	
motivate	.vb	.int	
motivation	.nn	.int	
motive	.nn/.aj	.hi	
motor	.nn	.int	
motorcycle	.nn	.elem	= motorbike (British English)
motorist	.nn	.hi	
motorway	.nn	.hi	
motto	.nn	.hi	
mound	.nn	.hi	
mount	.vb/.nn	.hi	
mountain	.nn	.elem	
mountainous	.aj	.int	
mounted	.aj	.hi	
mourn	.vb	.hi	
mournful	.aj	.hi	
mouse	.nn	.elem	
moustache	.nn	.int	= mustache
mouth	.nn	.elem	
mouthpiece	.nn	.hi	
movable	.aj	.int	
move	.vb/.nn	.elem	
movement	.nn	.elem	
movie	.nn	.elem	= film= cinema= picture
moving	.aj	.hi	
mow	.vb	.int	
mower	.nn	.hi	
Mr.	.nn	.elem	= Mr
Mrs.	.nn	.elem	= Mrs
MRT	.nn	.elem	= mass rapid transit= subway= underground= metro
Ms.	.nn	.elem	=Ms
MTV	.nn	.elem	
much	.pn/.av/.aj	.elem	
mud	.nn	.elem	
muddy	.aj	.int	
mug	.nn/.vb	.int	
mule	.nn	.hi	
multinational	.aj/.nn	.hi	
multiple	.aj	.int	
multiply	.vb	.int	
multitude	.nn	.hi	
mumble	.vb/.nn	.hi	
municipal	.aj	.hi	
murder	.nn/.vb	.int	
murderer	.nn	.int	
murmur	.vb/.nn	.int	
muscle	.nn	.int	
muscular	.aj	.hi	
muse	.vb/.nn	.hi	
museum	.nn	.elem	
mushroom	.nn/.vb	.int	
music	.nn	.elem	
musical	.aj/.nn	.int	
musician	.nn	.elem	
must	aux.	.elem	
mustache	.nn	.hi	
mustard	.nn	.hi	
mute	.aj/.vb/.nn/.av	.hi	
mutter	.vb/.nn	.hi	
mutton	.nn	.hi	
mutual	.aj	.int	
my	.de	.elem	
myself	.pn	.elem	
mysterious	.aj	.int	
mystery	.nn	.int	
myth	.nn	.hi	
mythology	.nn	.hi	
nadir	.nn	.hi	
nag	.vb/.nn	.hi	
nail	.nn/.vb	.elem	
naive	.aj	.hi	
naked	.aj	.int	
name	.nn/.vb	.elem	
namely	.av	.int	
nanny	.nn	.hi	
nap	.nn/.vb	.int	
napkin	.nn	.elem	
narrate	.vb	.hi	
narrative	.nn/.aj	.hi	
narrator	.nn	.hi	
narrow	.aj/.vb	.elem	
nasty	.aj	.int	
nation	.nn	.elem	
national	.aj	.elem	
nationalism	.nn	.hi	
nationalist	.aj/.nn	.hi	
nationality	.nn	.int	
nationwide	.aj/.av	.hi	
native	.aj/.nn	.int	
natural	.aj	.elem	
naturalist	.nn	.int	
naturally	.av	.int	
nature	.nn	.elem	
naughty	.aj	.elem	
naval	.aj	.int	
navel	.nn	.hi	
navigate	.vb	.hi	
navigation	.nn	.hi	
navy	.nn	.int	
near	.pr/.aj/.av/.vb	.elem	
nearby	.aj/.av	.int	
nearly	.av	.elem	
nearsighted	.aj	.hi	= short-sighted (American English)
neat	.aj	.int	
necessarily	.av	.int	
necessary	.aj	.elem	
necessitate	.vb	.hi	
necessity	.nn	.int	
neck	.nn	.elem	
necklace	.nn	.elem	
necktie	.nn	.hi	
need	.vb/.nn/aux.	.elem	
needle	.nn/.vb	.elem	
needy	.aj	.int	
negative	.aj/.nn	.elem	
neglect	.vb	.int	
negligible	.aj	.hi	
negotiate	.vb	.int	
negotiation	.nn	.int	
negotiator	.aj	.hi	
neighbor	.nn/.vb	.elem	= neighbour (British English)
neighborhood	.nn	.int	
neighboring	.aj	.hi	= neighbouring (British English)
neither	.av/.pn/.aj/.cj	.elem	
neon	.nn	.hi	
nephew	.nn	.elem	
nerve	.nn/.vb	.int	
nervous	.aj	.elem	
nest	.nn/.vb	.elem	
net	.aj/.nn/.vb	.int	
network	.nn/.vb	.int	
neutral	.aj/.nn	.hi	
never	.av	.elem	
nevertheless	.av	.int	
new	.aj	.elem	
New Year's Day	.nn	.elem	
New Year's Eve	.nn	.elem	
New York	.nn	.elem	
newcomer	.nn	.int	
newly	.av	.hi	
newlywed	.nn	.hi	
news	.nn	.elem	
newscast	.nn	.hi	
newscaster	.nn	.int	
newspaper	.nn	.elem	
newsreel	.nn	.hi	
next	.aj/.av	.elem	
nibble	.vb/.nn	.hi	
nice	.aj	.elem	
nick	.vb/.nn	.hi	
nickel	.nn/.vb	.hi	
nickname	.nn/.vb	.int	
niece	.nn	.elem	
night	.nn	.elem	
nightclub	.nn	.hi	
nightingale	.nn	.hi	
nightmare	.nn	.int	
nil	.nn	.hi	
nine	.nu/.pn/.nn/.aj	.elem	
nineteen	.nu/.pn/.nn/.aj	.elem	
ninety	.nu/.pn/.nn/.aj	.elem	
nitrogen	.nn	.hi	
no	.av/.aj/.nn	.elem	= nope
noble	.aj/.nn	.int	
nobody	.pn/.nn	.elem	
nod	.vb/.nn	.elem	
noise	.nn	.elem	
noisy	.aj	.elem	
nominal	.aj	.hi	
nominate	.vb	.hi	
nomination	.nn	.hi	
nominee	.nn	.hi	
none	.pn/.av	.elem	
nonetheless	.av	.int	
nonsense	.nn	.int	
non-stop	.aj/.av	.int	
non-violent	.aj	.hi	
noodle	.nn	.elem	
noon	.nn	.elem	
nor	.cj	.elem	
norm	.nn	.hi	
normal	.aj	.int	
normally	.av	.int	
north	.nn/.aj/.av	.elem	
north-east	.nn/.av/.aj	.int	
northern	.aj	.elem	
north-west	.nn/.av/.aj	.int	
nose	.nn	.elem	
nostril	.nn	.hi	
not	.av	.elem	
notable	.aj/.nn	.hi	
notably	.av	.hi	
notation	.nn	.hi	
note	.nn/.vb	.elem	
notebook	.nn	.elem	
noted	.aj	.hi	
nothing	.pn/.nn	.elem	
notice	.nn/.vb	.elem	
noticeable	.aj	.hi	
notify	.vb	.hi	
notion	.nn	.hi	
notorious	.aj	.hi	
notwithstanding	.pr/.av	.hi	
.nn	.nn	.int	
nourish	.vb	.int	
novel	.nn	.elem	
novel	.aj	.elem	
novelist	.nn	.int	
novelty	.nn	.hi	
November	.nn	.elem	= Nov.
novice	.nn	.hi	
now	.av/.nn/.pn	.elem	
nowadays	.av	.int	
nowhere	.av	.int	
nuclear	.aj	.int	
nucleus	.nn	.hi	
nude	.aj/.nn	.hi	
nuisance	.nn	.hi	
.nu	.nn/.vb	.elem	
numerical	.aj	.hi	
numerous	.aj	.int	
nun	.nn	.int	
nurse	.nn/.vb	.elem	
nursery	.nn	.int	
nursing	.nn/.aj	.int	
nurture	.vb/.nn	.hi	
nut	.nn	.int	
nutrient	.nn	.int	
nutrition	.nn	.int	
nutritious	.aj	.hi	
nylon	.nn	.int	
oak	.nn	.int	
oar	.nn	.hi	
oasis	.nn	.hi	
oath	.nn	.hi	
oatmeal	.nn	.hi	
obedience	.nn	.hi	
obedient	.aj	.int	
obey	.vb	.elem	
obituary	.nn	.hi	
object	.nn	.elem	物體, 對象 (P)
object	.vb	.elem	抗議, 反對 (P)
objection	.nn	.int	
objective	.nn/.aj	.int	
obligate	.vb	.hi	
obligation	.nn	.hi	
obligatory	.aj	.hi	
oblige	.vb	.hi	
oblong	.aj/.nn	.hi	
obscene	.aj	.hi	
obscure	.aj/.vb	.hi	
observation	.nn	.int	
observe	.vb	.int	
observer	.nn	.hi	
obsess	.vb	.hi	
obsession	.nn	.hi	
obstacle	.nn	.int	
obstinate	.aj	.hi	
obtain	.vb	.int	
obvious	.aj	.int	
obviously	.av	.int	
occasion	.nn	.int	
occasional	.aj	.int	
occupation	.nn	.int	
occupy	.vb	.int	
occur	.vb	.elem	
occurrence	.nn	.hi	
ocean	.nn	.elem	
o'clock	.av	.elem	
October	.nn	.elem	= Oct.
octopus	.nn	.hi	
odd	.aj	.int	
odds	.nn	.hi	
odor	.nn	.hi	= odour (British English)
of	.pr	.elem	
off	.av/.pr/.aj	.elem	
offend	.vb	.int	
offense	.nn	.int	= offence (British English)
offensive	.aj/.nn	.int	
offer	.vb/.nn	.elem	
offering	.nn	.hi	
office	.nn	.elem	
officer	.nn	.elem	
official	.nn/.aj	.elem	
offset	.vb/.nn/.aj	.hi	
offshore	.aj/.av	.hi	
offspring	.nn	.hi	
often	.av	.elem	
oh	.in	.int	
oil	.nn/.vb	.elem	
OK	.aj/.av/.nn/.vb	.elem	= O.K.= ok= o.k.
old	.aj	.elem	
old-fashioned	.aj	.hi	
olive	.nn/.aj	.hi	
Olympic	.aj	.int	
omit	.vb	.elem	
on	.pr/.av	.elem	
once	.av/.cj/.pn	.elem	
one	.nu/.pn/.nn/.aj	.elem	
oneself	.pn	.int	
one-sided	.aj	.int	
one-time	.aj	.hi	= onetime
ongoing	.aj	.hi	
onion	.nn	.elem	
only	.av/.aj/.cj	.elem	
onto	perp.	.int	
opaque	.aj	.hi	
open	.vb/.aj	.elem	
opener	.nn	.int	
opening	.nn/.aj	.int	
openly	.av	.hi	
opera	.nn	.int	
operate	.vb	.elem	
operation	.nn	.elem	
operational	.aj	.hi	
operative	.aj/.nn	.hi	
operator	.nn	.int	
opinion	.nn	.elem	
opponent	.nn	.int	
opportunity	.nn	.elem	
oppose	.vb	.int	
opposed	.aj	.hi	
opposite	.aj/.nn/.av	.int	
opposition	.nn	.int	
oppress	.vb	.hi	
oppression	.nn	.hi	
opt	.vb	.hi	
optical	.aj	.hi	
optimism	.nn	.hi	
optimistic	.aj	.hi	
optimum	.aj	.hi	= optimal
option	.nn	.int	
optional	.aj	.hi	
or	.cj	.elem	
oral	.aj/.nn	.int	
orange	.nn/.aj	.elem	
orbit	.nn/.vb	.int	
orchard	.nn	.hi	
orchestra	.nn	.int	
ordeal	.nn	.hi	
order	.nn	.elem	順序
order	.vb	.elem	命令,訂購
orderly	.aj/.nn	.int	
ordinary	.aj	.elem	
ore	.nn	.hi	
organ	.nn	.int	
organic	.aj	.int	
organism	.nn	.hi	
organization	.nn	.elem	= organisation (British English)
organize	.vb	.elem	= organise (British English)
organized	.aj	.hi	= organised (British English)
orient	.vb	.hi	= orientate
Orient	.nn	.hi	= East
oriental	.aj	.hi	= eastern
Oriental	.nn	.hi	
orientation	.nn	.hi	
oriented	.aj	.hi	
origin	.nn	.int	
original	.aj/.nn	.int	
originality	.nn	.hi	
originally	.av	.hi	
originate	.vb	.hi	
ornament	.nn/.vb	.hi	
orphan	.nn	.int	
orphanage	.nn	.int	
orthodox	.aj	.hi	
ostrich	.nn	.hi	
other	.aj/.pn	.elem	
otherwise	.av	.int	
ought	aux.	.int	
ounce	.nn	.int	= oz.
our	.de	.elem	
ours	.pn	.elem	
ourselves	.pn	.int	
oust	.vb	.hi	
out	.av/.aj/.pr	.elem	
outbreak	.nn	.hi	
outcome	.nn	.int	
outdo	.vb	.hi	
outdoor	.aj	.int	
outdoors	.av	.int	
outer	.aj	.int	
outfit	.nn/.vb	.hi	
outgoing	.aj	.hi	
outing	.nn	.hi	
outlaw	.vb/.nn	.hi	
outlet	.nn	.hi	
outline	.vb/.nn	.int	
outlook	.nn	.hi	
out.nu	.vb	.hi	
output	.nn	.int	
outrage	.vb/.nn	.hi	
outrageous	.aj	.hi	
outright	.aj/.av	.hi	
outset	.nn	.hi	
outside	.pr/.av/.aj/.nn	.elem	
outsider	.nn	.hi	
outskirts	.nn	.hi	
outstanding	.aj	.int	
outward 	.aj/.av	.int	
oval	.aj/.nn	.int	
oven	.nn	.elem	
over	.pr/.av/.aj	.elem	
overall	.aj/.av/.nn	.int	
overcoat	.nn	.int	
overcome	.vb	.int	
overdo	.vb	.hi	
overeat	.vb	.hi	
overflow	.vb/.nn	.int	
overhead 	.aj/.av	.int	
overhear	.vb	.hi	
overlap	.vb/.nn	.hi	
overlook	.vb	.int	
overnight	.av/.aj	.int	
overpass	.nn	.elem	
overseas	.aj/.av	.elem	
oversee	.vb	.hi	
oversleep	.vb	.hi	
overt	.aj	.hi	
overtake	.vb	.int	
overthrow	.vb/.nn	.int	
overturn	.vb	.hi	
over-weight	.aj	.int	
overwhelm	.vb	.hi	
overwhelming	.aj	.hi	
overwork	.vb/.nn	.hi	
owe	.vb	.int	
owl	.nn	.int	
own	.pn/.vb/.aj	.elem	
owner	.nn	.elem	
ownership	.nn	.int	
ox	.nn	.elem	
oxide	.nn	.hi	
oxygen	.nn	.int	
oyster	.nn	.hi	
ozone	.nn	.hi	
P.M.	.av	.elem	= p.m.= PM
pace	.nn/.vb	.int	
Pacific	.nn/.aj	.int	
pack	.vb/.nn	.elem	
package	.nn	.elem	
packaging	.nn	.hi	
packed	.aj	.hi	
packet	.nn	.int	
packing	.nn	.hi	
pact	.nn	.hi	
pad	.nn/.vb	.int	
paddle	.nn/.vb	.hi	
pagan	.aj/.nn	.hi	
page	.nn	.elem	= p.
paid	.aj	.hi	
pail	.nn	.hi	
pain	.nn	.elem	
painful	.aj	.elem	
paint	.vb/.nn	.elem	
painter	.nn	.elem	
painting	.nn	.elem	
pair	.nn	.elem	
pajamas	.nn	.elem	= pyjamas (British English)
pal	.nn	.int	
palace	.nn	.int	
pale	.aj	.elem	
palm	.nn/.vb	.int	
pamphlet	.nn	.hi	
pan	.nn	.elem	
pancake	.nn	.int	
panda	.nn	.elem	
pane	.nn	.hi	
panel	.nn	.int	
panic	.nn/.vb	.int	
pants	.nn	.elem	= trousers (British English)
papa	.nn	.int	= father
papaya	.nn	.elem	
paper	.nn	.elem	
paperback	.nn	.hi	
par	.nn	.hi	
parachute	.nn/.vb	.int	
parade	.nn/.vb	.int	
paradise	.nn	.int	
paradox	.nn	.hi	
paragraph	.nn	.int	
parallel 	.aj/.nn/.vb	.int	
paralysis	.nn	.hi	
paralyze	.vb	.hi	= paralyse (British English)
parameter	.nn	.hi	
parcel	.nn/.vb	.int	
pardon	.nn/.vb	.elem	
parent	.nn	.elem	
Paris	.nn	.elem	
parish	.nn	.hi	
park 	.nn	.elem	公園
park 	.vb	.elem	停車
parking	.nn	.int	
parliament	.nn	.int	
parliamentary	.aj	.hi	
parlor	.nn	.hi	= parlour
parrot	.nn	.elem	
parsley	.nn	.hi	
p.ar	.vb	.int	分開,分離
p.ar 	.nn	.elem	部分
p.arial	.aj	.int	
p.arially	.av	.hi	
p.aricipant	.nn	.int	
p.aricipate	.vb	.int	
p.aricipation	.nn	.hi	
p.ariciple	.nn	.int	
p.aricle	.nn	.hi	
p.aricular	.aj	.elem	
p.aricularly	.av	.int	
p.arition	.nn/.vb	.hi	
p.arly	.av	.hi	
p.arner	.nn	.elem	
p.arnership	.nn	.int	
p.ar-time	.aj/.av	.hi	
p.ary	.nn	.elem	
pass	.vb/.nn	.elem	
passage	.nn	.int	
passenger	.nn	.elem	
passing	.aj/.nn	.hi	
passion	.nn	.int	
passionate	.aj	.hi	
passive	.aj	.int	
passport	.nn	.int	
password	.nn	.hi	
past 	.pr/.av	.elem	經過,超過
past 	.nn/.aj	.elem	過往,以前的
pasta	.nn	.int	
paste	.nn/.vb	.elem	
pastime	.nn	.hi	
pastry	.nn	.hi	
pasture	.nn/.vb	.hi	
pat	.vb/.nn	.int	
patch	.nn/.vb	.hi	
patent	.nn/.vb/.aj	.hi	
path	.nn	.elem	
pathetic	.aj	.hi	
patience	.nn	.int	
patient 	.aj	.elem	耐心的
patient 	.nn	.elem	病患
patriot	.nn	.hi	
patriotic	.aj	.int	
patrol	.vb/.nn	.hi	
patron	.nn	.hi	
patronage	.nn	.hi	
pattern	.nn	.elem	
pause	.vb/.nn	.elem	
pave	.vb	.int	
pavement	.nn	.hi	
paw	.nn/.vb	.int	
pay	.vb/.nn	.elem	
payment	.nn	.int	
PDA	.nn	.hi	= personal digital assistant
PE	.nn	.elem	= physical education
pea	.nn	.int	
peace	.nn	.elem	
peaceful	.aj	.elem	
peacekeeping	.nn	.hi	
peach	.nn	.elem	
peacock	.nn	.hi	
peak	.nn/.aj/.vb	.int	
peanut	.nn	.int	
pear	.nn	.elem	
pearl	.nn/.aj	.int	
peasant	.nn	.int	
pebble	.nn	.int	
peck	.vb/.nn	.hi	
peculiar	.aj	.int	
pedal	.nn/.vb	.int	
peddle	.vb	.hi	
peddler	.nn	.hi	
pedestrian	.nn/.aj	.hi	
peek	.vb/.nn	.hi	
peel	.nn/.vb	.int	
peep	.vb/.nn	.int	
peer	.vb/.nn	.int	
peg	.nn/.vb	.hi	
pen	.nn	.elem	
penalty	.nn	.int	
pencil	.nn	.elem	
pending	.aj/.pr	.hi	
pendulum	.nn	.hi	
penetrate	.vb	.hi	
penguin	.nn	.int	
peninsula	.nn	.hi	
penis	.nn	.hi	
penny	.nn	.int	
pension	.nn/.vb	.hi	
pensioner	.nn	.hi	
people	.nn	.elem	
pepper	.nn	.elem	
per	.pr	.int	
perceive	.vb	.hi	
percent	.nn	.int	= per cent
percentage	.nn	.int	
perception	.nn	.hi	
perch	.vb/.nn	.hi	
perennial	.aj/.nn	.hi	
perfect	.vb	.hi	(P)
perfect 	.aj	.elem	完美
perfection	.nn	.int	
perfectly	.av	.int	
perform	.vb	.int	
performance	.nn	.int	
performer	.nn	.int	
perfume	.nn/.vb	.int	
perhaps	.av	.elem	
peril	.nn/.vb	.hi	
period	.nn	.elem	
periodic	.aj	.hi	
periodical	.nn/.aj	.hi	
perish	.vb	.hi	
permanent	.aj/.nn	.int	
permeate	.vb	.hi	
permissible	.aj	.hi	
permission	.nn	.int	
permit	.vb/.nn	.int	
perpetual	.aj	.hi	
perplex	.vb	.hi	
perseverance	.nn	.hi	
persevere	.vb	.hi	
persist	.vb	.int	
persistence	.nn	.hi	
persistent	.aj	.hi	
person	.nn	.elem	
personal	.aj	.elem	
personality	.nn	.int	
personnel	.nn	.hi	
perspective	.nn	.hi	
persuade	.vb	.int	
persuasion	.nn	.int	
persuasive	.aj	.int	
pertain	.vb	.hi	
pertinent	.aj	.hi	
pessimism	.nn	.hi	
pessimistic	.aj	.int	
pest	.nn	.int	
pesticide	.nn	.hi	
pet	.nn	.elem	
petal	.nn	.int	
petition	.nn/.vb	.hi	
petrol	.nn	.int	= gas, gasoline (American English)
petroleum	.nn	.hi	
petty	.aj	.hi	
pharmaceutical	.aj/.nn	.hi	
pharmacist	.nn	.hi	
pharmacology	.nn	.hi	
pharmacy	.nn	.hi	
phase	.nn/.vb	.hi	
phenomenon	.nn	.int	phenomena (plural form)
Philippines	.nn	.elem	
philosopher	.nn	.int	
philosophical	.aj	.int	
philosophy	.nn	.int	
phone	.nn/.vb	.elem	= telephone
photo	.nn	.elem	= photograph
photograph	.nn	.elem	= photo
photographer	.nn	.elem	
photographic	.aj	.int	
photography	.nn	.int	
phrase	.nn/.vb	.int	
physical	.aj/.nn	.int	
physician	.nn	.int	
physicist	.nn	.int	
physics	.nn	.elem	
physiological	.aj	.hi	
physiology	.nn	.hi	
pianist	.nn	.int	
piano	.nn	.elem	
pick	.vb	.elem	
pickle	.nn/.vb	.hi	
pickpocket	.nn	.hi	
pick-up	.nn	.hi	
picnic	.nn/.vb	.elem	
picture	.nn/.vb	.elem	
picturesque	.aj	.hi	
pie	.nn	.elem	
piece	.nn	.elem	
pier	.nn	.hi	
pierce	.vb	.hi	
piercing	.aj	.hi	
piety	.nn	.hi	
pig	.nn	.elem	
pigeon	.nn	.elem	
pile	.vb/.nn	.elem	
pilgrim	.nn	.int	
pill	.nn	.int	
pillar	.nn	.hi	
pillow	.nn	.elem	
pilot	.nn/.vb	.int	
pimple	.nn	.hi	
pin	.nn/.vb	.elem	
pinch	.vb/.nn	.hi	
pine	.nn	.int	松樹
pine	.vb	.int	渴望
pineapple	.nn	.elem	
ping-pong	.nn	.int	= table tennis
pink 	.aj/.nn	.elem	粉紅的,粉紅色
pint	.nn	.int	
pioneer	.nn/.vb	.int	
pious	.aj	.hi	
pipe	.nn	.elem	
pipeline	.nn	.hi	
pirate	.nn/.vb/.aj	.int	
piss	.vb/.nn	.hi	
pistol	.nn	.hi	
pit	.nn/.vb	.int	
pitch	.nn/.vb	.int	
pitcher	.nn	.hi	
pity	.nn/.vb	.int	
pizza	.nn	.elem	
place	.nn/.vb	.elem	
plague	.nn/.vb	.hi	
plain 	.nn	.elem	草原
plain 	.aj/.av	.elem	素色的,平實的,樸素的
plan	.nn/.vb	.elem	
plane	.nn	.elem	
planet	.nn	.elem	
plant 	.vb	.elem	種植
plant 	.nn	.elem	植物
plantation	.nn	.hi	
plaster	.nn/.vb	.hi	
plastic	.nn/.aj	.int	
plate	.nn	.elem	
plateau	.nn	.hi	
platform	.nn	.elem	
plausible	.aj	.hi	
play 	.vb	.elem	玩,打(球),彈奏,扮演
play 	.nn	.elem	戲劇
player	.nn	.elem	
playful	.aj	.hi	
playground	.nn	.elem	
playwright	.nn	.hi	
plea	.nn/.vb	.hi	
plead	.vb	.hi	
pleasant	.aj	.elem	
please 	.vb	.elem	取悅
please 	.av	.elem	請
pleased	.aj	.elem	
pleasure	.nn	.elem	
pledge	.nn/.vb	.hi	
plentiful	.aj	.int	
plenty	.pn/adv	.int	
plight	.nn	.hi	
plot	.nn/.vb	.int	
plow	.nn/.vb	.hi	= plough (British English)
pluck	.vb/.nn	.hi	
plug	.nn/.vb	.int	
plum	.nn/.aj	.int	
plumber	.nn	.int	
plunge	.vb/.nn	.hi	
plural	.aj/.nn	.int	
plus	.pr/.cj/.aj/.nn	.elem	
pneumonia	.nn	.hi	
poach	.vb	.hi	
pocket	.nn/.aj/.vb	.elem	
pocketbook	.nn	.hi	
poem	.nn	.elem	
poet	.nn	.int	
poetic	.aj	.hi	
poetry	.nn	.int	
point 	.vb	.elem	指向
point 	.nn	.elem	點
pointed	.aj	.hi	
poised	.aj	.hi	
poison	.nn/.vb	.elem	
poisonous	.aj	.int	
poke	.vb/.nn	.hi	
polar	.aj	.hi	
pole	.nn	.int	
police	.nn	.elem	
policeman	.nn	.elem	= cop
policy	.nn	.elem	
polish	.nn/.vb	.int	
polite	.aj	.elem	
political	.aj	.int	
politician	.nn	.int	
politics	.nn	.int	
poll	.nn/.vb	.int	
pollutant	.aj/.nn	.hi	
pollute	.vb	.elem	
pollution	.nn	.elem	
polytechnic	.nn	.hi	
pond	.nn	.elem	
ponder	.vb	.hi	
pony	.nn	.int	
pool	.nn	.elem	
poor	.aj	.elem	
pop	.nn/.vb	.int	
popcorn	.nn	.elem	
pope	.nn	.hi	
popular	.aj	.elem	
popularity	.nn	.hi	
populate	.vb	.hi	
population	.nn	.elem	
porcelain	.nn	.hi	= china 瓷器
porch	.nn	.hi	
pore	.nn/.vb	.hi	
pork	.nn	.elem	
port	.nn/.aj	.int	
portable	.aj/.nn	.int	
porter	.nn	.int	
portfolio	.nn	.hi	
portion	.nn	.int	
portrait	.nn	.int	
portray	.vb	.int	
pose	.vb/.nn	.int	
position	.nn/.vb	.elem	
positive	.aj	.elem	
possess	.vb	.int	
possession	.nn	.int	
possibility	.nn	.int	
possible	.aj	.elem	
possibly	.av	.int	
post	.nn	.int	柱子
post 	.nn/.vb	.elem	= mail (American English) 郵件,包裹,郵寄
post 	.nn	.elem	職位
postage	.nn	.int	
postal	.aj	.int	
postcard	.nn	.elem	
poster	.nn	.int	
postman	.nn	.int	
postpone	.vb	.int	
postulate	.vb/.nn	.hi	
posture	.nn/.vb	.hi	
post-war	.aj/.av	.hi	= postwar
pot	.nn	.elem	
potato	.nn	.elem	
potent	.aj	.hi	
potential	.aj/.nn	.int	
potter	.nn	.hi	
pottery	.nn	.int	
poultry	.nn	.int	
pound	.vb	.int	猛烈敲擊
pound 	.nn	.elem	磅 = lb., 鎊
pour	.vb	.int	
poverty	.nn	.int	
powder	.nn/.vb	.elem	
power	.nn	.elem	
powerful	.aj	.elem	
powerless	.aj	.int	
practicable	.aj	.hi	
practical	.aj/.nn	.int	
practice	.nn/.vb	.elem	= practise(verb, British English)
practise	.vb	.int	
practitioner	.nn	.hi	
prairie	.nn	.hi	
praise	.vb/.nn	.elem	
pray	.vb	.elem	
prayer	.nn	.int	
preach	.vb	.hi	
precaution	.nn	.hi	
precede	.vb	.hi	
precedent	.nn	.hi	
preceding	.aj	.hi	
precious	.aj	.elem	
precipitate	.vb/.aj	.hi	
precise	.aj	.int	
precisely	.av	.hi	
precision	.nn	.hi	
preclude	.vb	.hi	
predecessor	.nn	.hi	
predict	.vb	.int	
predictable	.aj	.hi	
prediction	.nn	.int	
predominant	.aj	.hi	
predominantly	.av	.hi	
preface	.nn/.vb	.hi	
prefer	.vb	.elem	
preferable	.aj	.int	
preference	.nn	.hi	
pregnancy	.nn	.int	
pregnant	.aj	.int	
prehistoric	.aj	.hi	
prejudice	.nn/.vb	.hi	
preliminary	.aj/.nn	.hi	
premature	.aj	.hi	
premier	.nn/.aj	.hi	
premiere	.nn/.vb	.hi	
premise	.nn	.hi	
premium	.nn/.aj	.hi	
preparation	.nn	.int	
prepare	.vb	.elem	
prepared	.aj	.int	
preposition	.nn	.hi	
prescribe	.vb	.hi	
prescription	.nn	.hi	
presence	.nn	.int	
present	.vb	.hi	
present 	.aj	.elem	現在的,出席的
present 	.nn	.elem	禮物 
presentation	.nn	.int	
presently	.av	.int	
preservation	.nn	.hi	
preserve	.vb/.nn	.int	
preside	.vb	.hi	
presidency	.nn	.hi	
president	.nn	.elem	
president-elect	.nn	.hi	
presidential	.aj	.int	
press 	.nn	.elem	新聞界,印刷出版業
press 	.vb	.elem	按,壓,催迫
pressure	.nn/.vb	.int	
prestige	.nn/.aj	.hi	
prestigious	.aj	.hi	
presumably	.av	.hi	
presume	.vb	.hi	
pretend	.vb	.int	
pretext	.nn	.hi	
pretty 	.aj	.elem	漂亮的
pretty 	.av	.elem	很,非常
prevail	.vb	.hi	
prevailing	.aj	.hi	
prevalent	.aj	.hi	
prevent	.vb	.int	
prevention	.nn	.int	
preventive	.aj/.nn	.hi	
preview	.nn/.vb	.int	
previous	.aj	.int	
previously	.av	.hi	
prey	.nn/.vb	.hi	
price	.nn/.vb	.elem	
priceless	.aj	.hi	
prick	.vb/.nn	.hi	
pride	.nn/.vb	.int	
priest	.nn	.elem	
primarily	.av	.hi	
primary	.aj/.nn	.elem	
primary 	.aj	.int	主要的;基本的
prime	.aj/.nn/.vb	.int	
primitive	.aj	.int	
prince	.nn	.elem	
princess	.nn	.elem	
principal	.aj	.hi	
principal 	.nn	.elem	
principle	.nn	.elem	
print	.vb/.nn	.elem	
printer	.nn	.elem	
prior	.aj/.nn	.hi	
priority	.nn	.hi	
prison	.nn	.elem	
prisoner	.nn	.elem	
privacy	.nn	.int	
private	.aj	.elem	
privatize	.vb	.hi	
privilege	.nn/.vb	.int	
privileged	.aj/.nn	.hi	
prize	.nn	.elem	
pro	.nn/.aj	.hi	
pro	.pr	.hi	
probability	.nn	.hi	
probable	.aj	.int	
probably	.av	.elem	
probe	.vb/.nn	.hi	
problem	.nn	.elem	
procedure	.nn	.int	
proceed	.vb/.nn	.int	
proceeding	.nn	.hi	
process	.nn/.vb	.int	
procession	.nn	.hi	
processor	.nn	.hi	
proclaim	.vb	.hi	
produce	.nn	.hi	農產品 (P) 
produce 	.vb	.elem	製造
producer	.nn	.int	
product	.nn	.elem	
production	.nn	.elem	
productive	.aj	.int	
productivity	.nn	.hi	
profession	.nn	.int	
professional	.aj/.nn	.int	
professor	.nn	.elem	
proficiency	.nn	.hi	
proficient	.aj	.hi	
profile	.nn/.vb	.hi	
profit	.nn/.vb	.int	
profitable	.aj	.int	
profound	.aj	.hi	
program	.nn/.vb	.elem	= programme (British English)
progress	.nn/.vb	.elem	
progressive	.aj/.nn	.int	
prohibit	.vb	.int	
prohibition	.nn	.hi	
project	.vb	.hi	(P)
project 	.nn	.elem	計劃 
projection	.nn	.hi	
proliferate	.vb	.hi	
prolong	.vb	.hi	
prolonged	.aj	.hi	
prominent	.aj	.int	
promise	.vb/.nn	.elem	
promising	.aj	.int	
promote	.vb	.int	
promotion	.nn	.int	
prompt	.vb/.nn/.aj	.int	
promptly	.av	.hi	
prone	.aj	.hi	
pro.nn	.nn	.hi	
pro.nnce	.vb	.elem	
pronunciation	.nn	.int	
proof	.nn/.aj	.int	
prop	.vb/.nn	.hi	
propaganda	.nn	.hi	
propagate	.vb	.hi	
propel	.vb	.hi	
propeller	.nn	.hi	
proper	.aj	.int	
properly	.av	.int	
property	.nn	.int	
prophet	.nn	.hi	
proportion	.nn	.int	
proportional	.aj	.hi	
proposal	.nn	.int	
propose	.vb	.elem	
proposition	.nn/.vb	.hi	
prose	.nn	.hi	
prosecute	.vb	.hi	
prosecution	.nn	.hi	
prosecutor	.nn	.hi	
prospect	.vb	.hi	
prospect 	.nn	.int	前景 (P)
prospective	.aj	.hi	
prosper	.vb	.int	
prosperity	.nn	.int	
prosperous	.aj	.int	
prostitute	.nn/.vb	.hi	
prostitution	.nn	.hi	
protect	.vb	.elem	
protection	.nn	.elem	
protective	.aj	.int	
protein	.nn	.int	
protest	.nn/.vb	.int	
prototype	.nn	.hi	
proud	.aj	.elem	
prove	.vb	.elem	
pro.vb	.nn	.int	
provide	.vb	.elem	
provided	.cj	.hi	provided that= providing that
province	.nn	.int	
provincial	.aj/.nn	.hi	
provision	.nn/.vb	.hi	
provisional	.aj	.hi	
provocative	.aj	.hi	
provoke	.vb	.hi	
prowl	.vb/.nn	.hi	
proximity	.nn	.hi	
prune	.nn/.vb	.hi	
psychiatric	.aj	.hi	
psychiatrist	.nn	.hi	
psychiatry	.nn	.hi	
psychic	.aj/.nn	.hi	adj.= psychical
psychological	.aj	.int	
psychologist	.nn	.int	
psychology	.nn	.int	
pub	.nn	.int	
public	.aj/.nn	.elem	
publication	.nn	.int	
publicity	.nn	.int	
publicize	.vb	.hi	
publish	.vb	.int	
publisher	.nn	.int	
pudding	.nn	.int	
puff	.nn/.vb	.hi	
pull	.vb/.nn	.elem	
pulse	.nn/.vb	.hi	
pump	.nn/.vb	.elem	
pumpkin	.nn	.elem	
punch	.nn/.vb	.int	
punctual	.aj	.int	
punish	.vb	.elem	
punishment	.nn	.hi	
punk	.nn/.aj	.hi	
pupil	.nn	.int	
puppet	.nn	.int	
puppy	.nn	.elem	
purchase	.nn/.vb	.elem	
pure	.aj	.int	
purely	.av	.hi	
purify	.vb	.hi	
purity	.nn	.hi	
purple	.aj/.nn	.elem	
purpose	.nn	.elem	
purse	.nn	.elem	
pursue	.vb	.int	
pursuit	.nn	.int	
push	.vb/.nn	.elem	
put	.vb	.elem	
put-down	.nn	.hi	
putt	.nn/.vb	.hi	
puzzle	.nn/.vb	.elem	
pyramid	.nn	.hi	
quack	.nn/.vb	.hi	
quake	.vb/.nn	.hi	noun= earthquake
qualification	.nn	.int	
qualified	.aj	.int	
qualifier	.nn	.hi	
qualify	.vb	.int	
qualitative	.aj	.hi	
quality	.nn	.elem	
quantify	.vb	.hi	
quantitative	.aj	.hi	
quantity	.nn	.int	
quantum	.aj/.nn	.hi	
quarrel	.nn/.vb	.int	
quarrelsome	.aj	.hi	
qu.ar	.nn	.hi	
qu.arer	.nn	.elem	
qu.arer-final	.nn	.hi	
qu.arerly	.aj/.av/.nn	.hi	
qu.aret	.nn	.hi	= quartette
qu.arz	.nn	.hi	
queen	.nn	.elem	
queer	.aj/.nn/.vb	.hi	
quench	.vb	.hi	
query	.nn/.vb	.hi	
quest	.nn/.vb	.hi	
question	.nn/.vb	.elem	
questionnaire	.nn	.hi	
queue	.nn/.vb	.int	
quick	.aj	.elem	
quiet	.aj	.elem	
quilt	.nn	.int	
quit	.vb	.elem	
quite	.av	.elem	
quiver	.vb/.nn	.hi	
quiz	.nn	.elem	
quota	.nn	.hi	
quotation	.nn	.hi	
quote	.vb/.nn	.int	
rabbit	.nn	.elem	
race 	.vb/.nn	.elem	比賽, 種族
racial	.aj	.int	
racing	.aj/.nn	.hi	
racism	.nn	.hi	
racist	.aj/.nn	.hi	
rack	.nn	.hi	
rack	.vb	.hi	
radar	.nn	.int	
radiant	.aj	.hi	
radiate	.vb	.hi	
radiation	.nn	.int	
radiator	.nn	.hi	
radical	.aj/.nn	.int	
radio	.nn	.elem	
radioactive	.aj	.hi	
radish	.nn	.hi	
radius	.nn	.hi	
raft	.nn/.vb	.hi	
rag	.nn	.hi	
rag	.vb	.hi	
rage	.nn/.vb	.int	
ragged	.aj	.hi	
raid	.vb/.nn	.hi	
rail	.nn/.vb	.hi	
railroad	.nn	.elem	= railway (British English)
railway	.nn	.int	
rain	.nn/.vb	.elem	
rainbow	.nn	.elem	
raincoat	.nn	.int	
rainfall	.nn	.int	
rainy	.aj	.elem	
raise	.vb/.nn	.elem	
raisin	.nn	.int	
rally	.nn/.vb	.hi	
ranch	.nn	.hi	
random	.aj/.nn	.hi	
range	.nn/.vb	.elem	
rank	.nn/.vb	.int	
ranking	.aj/.nn	.hi	
ransom	.nn/.vb	.hi	
rap	.nn/.vb	.hi	
rape	.vb/.nn	.hi	
rapid	.aj	.elem	
rare	.aj	.elem	
rarely	.av	.int	
rascal	.nn	.hi	
rash	.aj/.nn	.hi	
rat	.nn	.elem	
rate	.nn/.vb	.int	
rather	.av	.elem	
ratify	.vb	.hi	
rating	.nn	.hi	
ratio	.nn	.hi	
rational	.aj	.hi	
rattle	.vb/.nn	.hi	
ravage	.vb	.hi	
rave	.vb/.nn/.aj	.hi	
raw	.aj	.int	
ray	.nn	.int	
razor	.nn	.int	
reach	.vb/.nn	.elem	
react	.vb	.int	
reaction	.nn	.int	
reactor	.nn	.hi	
read	.vb	.elem	
reader	.nn	.int	
readily	.av	.int	
reading	.nn	.int	
ready	.aj	.elem	
real	.aj	.elem	
realism	.nn	.hi	
realistic	.aj	.int	
reality	.nn	.int	
realization	.nn	.hi	= realisation (British English)
realize	.vb	.elem	= realise (British English)
really	.av	.elem	
realm	.nn	.hi	
reap	.vb	.hi	
rear	.aj/.nn/.vb	.int	
reason	.nn	.elem	
reasonable	.aj	.int	
reassure	.vb	.hi	
rebel	.nn/.vb	.int	(P)
rebellion	.nn	.hi	
rebellious	.aj	.hi	
rebuild	.vb	.int	
recall	.vb/.nn	.int	
receipt	.nn	.int	
receive	.vb	.elem	
receiver	.nn	.int	
recent	.aj	.elem	
recently	.av	.elem	
reception	.nn	.int	
recession	.nn	.int	
recipe	.nn	.int	
recipient	.nn	.hi	
reciprocal	.aj	.hi	
recite	.vb	.int	
reckless	.aj	.hi	
reckon	.vb	.hi	
reclaim	.vb	.hi	
recognition	.nn	.int	
recognize	.vb	.int	
recommend	.vb	.int	
recommendation	.nn	.hi	
reconcile	.vb	.hi	
reconciliation	.nn	.hi	
reconstruction	.nn	.hi	
record	.nn/.vb	.elem	(P)
recorder	.nn	.int	
recording	.nn	.hi	
recover	.vb	.elem	
recovery	.nn	.int	
recreation	.nn	.int	
recreational	.aj	.hi	
recruit	.vb/.nn	.hi	
rectangle	.nn	.elem	
rectangular	.aj	.hi	
rectify	.vb	.hi	
recur	.vb	.hi	
recycle	.vb	.elem	
red	.aj/.nn	.elem	
reduce	.vb	.int	
reduction	.nn	.int	
redundancy	.nn	.hi	
redundant	.aj	.hi	
reef	.nn	.hi	
reel	.nn/.vb	.hi	
refer	.vb	.int	
referee	.nn/.vb	.hi	
reference	.nn	.int	
referendum	.nn	.hi	
refine	.vb	.hi	
reflect	.vb	.int	
reflection	.nn	.int	
reflective	.aj	.hi	
reform	.nn/.vb	.int	
reformer	.nn	.hi	
refrain	.vb/.nn	.hi	
refresh	.vb	.int	
refreshing	.aj	.hi	
refreshment	.nn	.hi	
refrigerator	.nn	.elem	= fridge= icebox
refuge	.nn	.hi	
refugee	.nn	.int	
refund	.nn/.vb	.hi	
refusal	.nn	.int	
refuse	.nn	.int	垃圾 (P)
refuse 	.vb	.elem	拒絕
refute	.vb	.hi	
regain	.vb	.hi	
regard	.vb/.nn	.elem	
regarding	.pr	.int	
regardless	.av	.int	
reggae	.nn	.hi	
regime	.nn	.hi	
regiment	.nn	.hi	
region	.nn	.elem	
regional	.aj	.int	
register	.vb/.nn	.int	
registration	.nn	.int	
regret	.vb/.nn	.elem	
regular	.aj	.elem	
regulate	.vb	.int	
regulation	.nn	.int	
regulator	.nn	.hi	
rehabilitate	.vb	.hi	
rehearsal	.nn	.int	
rehearse	.vb	.int	
reign	.vb/.nn	.hi	
rein	.nn/.vb	.hi	
reinforce	.vb	.hi	
reject	.vb	.elem	
rejection	.nn	.hi	
rejoice	.vb	.hi	
relate	.vb	.int	
related	.aj	.int	
relation	.nn	.int	
relationship	.nn	.int	
relative	.aj/.nn	.elem	
relatively	.av	.int	
relativity	.nn	.hi	
relax	.vb	.int	
relaxation	.nn	.int	
relaxed	.aj	.hi	
relay	.nn/.vb	.hi	
release	.vb/.nn	.int	
relegate	.vb	.hi	
relentless	.aj	.hi	
relevant	.aj	.hi	
reliability	.nn	.hi	
reliable	.aj	.int	
reliance	.nn	.hi	
relic	.nn	.hi	
relief	.nn	.int	
relieve	.vb	.int	
relieved	.aj	.hi	
religion	.nn	.int	
religious	.aj	.int	
relish	.vb/.nn	.hi	
reluctant	.aj	.int	
rely	.vb	.int	
remain	.vb	.int	
remainder	.nn/.vb	.hi	
remaining	.aj	.hi	
remains	.nn	.hi	
remark	.nn/.vb	.int	
remarkable	.aj	.int	
remedy	.nn/.vb	.int	
remember	.vb	.elem	
remind	.vb	.elem	
reminder	.nn	.int	
reminiscent	.aj	.hi	
remnant	.nn	.hi	
remote	.aj	.int	
removal	.nn	.hi	
remove	.vb	.int	
renaissance	.nn	.hi	
render	.vb	.hi	
renew	.vb	.int	
renewal	.nn	.hi	
renowned	.aj	.hi	
rent	.nn/.vb	.elem	
rental	.nn/.aj	.hi	
reopen	.vb	.hi	
reorganize	.vb	.hi	= reorganise (British English)
repair	.nn/.vb	.elem	
repatriate	.vb	.hi	
repay	.vb	.hi	
repayment	.nn	.hi	
repeat	.vb	.elem	
repeated	.aj	.hi	
repeatedly	.av	.int	
repel	.vb	.hi	
repertoire	.nn	.hi	
repetition	.nn	.int	
replace	.vb	.int	
replacement	.nn	.hi	
replay	.vb/.nn	.hi	
reply	.vb/.nn	.elem	
report	.nn/.vb	.elem	
reportedly	.av	.hi	
reporter	.nn	.elem	
reporting	.nn	.int	
represent	.vb	.int	
representation	.nn	.int	
representative	.nn/.aj	.int	
repress	.vb	.hi	
repression	.nn	.hi	
reproach	.vb/.nn	.hi	
reproduce	.vb	.hi	
reproduction	.nn	.hi	
reptile	.nn/.aj	.hi	
republic	.nn	.int	
Republic of China	.nn	.elem	= ROC
republican	.nn/.aj	.int	
reputation	.nn	.int	
request	.nn/.vb	.int	
require	.vb	.elem	
requirement	.nn	.int	
rescue	.nn/.vb	.int	
research	.nn/.vb	.int	(P)
researcher	.nn	.int	
resemblance	.nn	.hi	
resemble	.vb	.int	
resent	.vb	.hi	
resentment	.nn	.hi	
reservation	.nn	.int	
reserve	.nn/.vb	.int	
reserved	.aj	.hi	
reservoir	.nn	.hi	
reside	.vb	.hi	
residence	.nn	.int	
resident	.nn/.aj	.int	
residential	.aj	.hi	
resign	.vb	.int	
resignation	.nn	.int	
resigned	.aj	.hi	
resist	.vb	.int	
resistance	.nn	.int	
resistant	.aj	.int	
resolute	.aj	.hi	
resolution	.nn	.int	
resolve	.vb	.int	
resonance	.nn	.hi	
resonant	.aj	.hi	
resort	.vb/.nn	.hi	
resource	.nn	.int	
respect	.nn/.vb	.elem	
respectable	.aj	.hi	
respected	.aj	.hi	
respectful	.aj	.hi	
respective	.aj	.hi	
respectively	.av	.hi	
respond	.vb	.int	
response	.nn	.int	
responsibility	.nn	.int	
responsible	.aj	.elem	
rest	.vb/.nn	.elem	休息
rest 	.nn/.pn	.elem	其餘的
restaurant	.nn	.elem	
restless	.aj	.int	
restore	.vb	.int	
restrain	.vb	.hi	
restrained	.aj	.hi	
restraint	.nn	.hi	
restrict	.vb	.int	
restricted	.aj	.hi	
restriction	.nn	.int	
restroom	.nn	.elem	= rest room
restructure	.vb	.hi	
result	.nn/.vb	.elem	
resultant	.aj	.hi	
resume	.vb	.hi	
résumé	.nn	.hi	
retail	.nn/.av/.vb	.hi	
retailer	.nn	.hi	
retain	.vb	.int	
retaliate	.vb	.hi	
retention	.nn	.hi	
retire	.vb	.int	
retired	.aj	.hi	
retirement	.nn	.hi	
retort	.vb/.nn	.hi	
retreat	.nn/.vb	.int	
retrieval	.nn	.hi	
retrieve	.vb	.hi	
retrospect	.nn	.hi	
retrospection	.nn	.hi	
retrospective	.aj	.hi	
return	.vb/.nn	.elem	
reunion	.nn	.hi	
reunite	.vb	.int	
reveal	.vb	.int	
revealing	.aj	.hi	
revelation	.nn	.hi	
revenge	.nn/.vb	.int	
revenue	.nn	.hi	
reverse	.vb/.nn/.aj	.hi	
review	.nn/.vb	.elem	
revise	.vb	.elem	
revision	.nn	.int	
revival	.nn	.hi	
revive	.vb	.hi	
revolt	.nn/.vb	.hi	
revolution	.nn	.int	
revolutionary	.aj	.int	
revolve	.vb	.hi	
reward	.nn/.vb	.int	
rewrite	.vb/.nn	.int	
rhetoric	.nn	.hi	
rhetorical	.aj	.hi	
rhinoceros	.nn	.hi	= rhino
rhyme	.vb/.nn	.int	
rhythm	.nn	.int	
rhythmic	.aj	.hi	
rib	.nn/.vb	.hi	
ribbon	.nn	.int	
rice	.nn	.elem	
rich	.aj/.nn	.elem	
riches	.nn	.int	財富
rid	.vb/.aj	.int	
riddle	.nn/.vb	.int	
ride	.vb/.nn	.elem	
rider	.nn	.int	
ridge	.nn/.vb	.hi	
ridicule	.nn/.vb	.hi	
ridiculous	.aj	.int	
rifle	.nn/.vb	.int	
rig	.vb/.nn	.hi	
right 	.aj/.av	.elem	正確的,適宜的;準確地,完全地 
right 	.aj/.av/.nn	.elem	右邊（的）
right 	.nn	.elem	權利
right-hand	.aj	.hi	
right-wing	.aj/.nn	.hi	= right wing
rigid	.aj	.hi	
rigor	.nn	.hi	= rigour
rigorous	.aj	.hi	
rim	.nn	.hi	
ring 	.vb	.elem	打電話,按鈴
ring 	.nn	.elem	鈴響,鈴聲;戒指
riot	.nn/.vb	.hi	
riotous	.aj	.hi	
rip	.vb/.nn	.hi	
ripe	.aj	.int	
ripple	.nn/.vb	.hi	
rise	.vb/.nn	.elem	
risk	.nn/.vb	.int	
risky	.aj	.hi	
rite	.nn	.hi	
ritual	.nn/.aj	.hi	
rival	.nn/.aj/.vb	.int	
rivalry	.nn	.hi	
river	.nn	.elem	
roach	.nn	.hi	蟑螂= cockroach
road	.nn	.elem	
roam	.vb/.nn	.hi	
roar	.vb/.nn	.int	
roast	.vb/.aj/.nn	.int	
rob	.vb	.elem	
robber	.nn	.int	
robbery	.nn	.int	
robe	.nn	.int	
robin	.nn	.hi	
robot	.nn	.elem	
robust	.aj	.hi	
rock 	.nn	.elem	岩石
rock 	.vb	.elem	搖動,震動
rocket	.nn/.vb	.int	
rocky	.aj	.hi	
rod	.nn	.int	
role	.nn	.elem	
roll	.vb/.nn	.elem	
roller	.nn	.hi	
romance	.nn/.vb/.aj	.int	
romantic	.aj/.nn	.int	
roof	.nn	.elem	
room	.nn	.elem	
rooster	.nn	.int	= cock (British English)
root	.nn/.vb/.aj	.elem	
rope	.nn	.elem	
rose	.nn	.elem	
rot	.vb/.nn	.int	
rotary	.aj	.hi	= rotatory
rotate	.vb	.hi	
rotation	.nn	.hi	
rotten	.aj	.int	
rouge	.nn/.vb	.hi	
rough	.aj/.av/.vb	.int	
roughly	.av	.hi	
round	.av/.pr/.nn/.aj	.elem	
rouse	.vb	.hi	
route	.nn/.vb	.int	
routine	.nn/.aj	.int	
row	.nn/.vb	.hi	爭吵(P)
row 	.nn	.elem	排,行,列
row 	.vb	.elem	划船
royal	.aj	.elem	
royalty	.nn	.hi	
rub	.vb	.elem	摩擦,揉
rubber	.aj/.nn	.elem	
rubbish	.nn/.aj/.vb	.int	(used mainly in British English)
ruby	.nn	.hi	
rude	.aj	.elem	
rug	.nn	.int	
rugby	.nn	.hi	
rugged	.aj	.hi	
ruin	.nn/.vb	.elem	
rule	.nn/.vb	.elem	
ruler	.nn	.elem	
ruling	.aj/.nn	.hi	
rumble	.vb/.nn	.hi	
rumour	.nn	.int	= rumor (American English)
run	.vb/.nn	.elem	
runner	.nn	.int	
runner-up	.nn	.hi	
running	.nn/.aj	.int	
run-up	.nn	.hi	
rupture	.nn/.vb	.hi	
rural	.aj	.int	
rush	.vb/.nn	.elem	
Russia	.nn	.elem	
Russian	.aj/.nn	.elem	
rust	.nn/.vb	.int	
rustle	.vb/.nn	.hi	
rusty	.aj	.int	
ruthless	.aj	.hi	
sack	.vb/.nn	.int	
sacred	.aj	.hi	
sacrifice	.vb/.nn	.int	
sad	.aj	.elem	
sadden	.vb	.int	
saddle	.nn/.vb	.hi	
safari	.nn	.hi	
safe 	.aj	.elem	安全的
safe 	.nn	.elem	保險櫃
safeguard	.vb/.nn	.hi	
safely 	.av	.int	
safety	.nn	.elem	
sail	.vb/.nn	.elem	
sailing	.nn	.int	
sailor	.nn	.elem	
saint	.nn	.hi	
sake	.nn	.int	
salad	.nn	.elem	
salary	.nn	.int	
sale	.nn	.elem	
salesman	.nn	.elem	
salesperson	.nn	.int	
salmon	.nn	.hi	
salon	.nn	.hi	
saloon	.nn	.hi	
salt	.nn	.elem	
salty	.aj	.int	
salutation	.nn	.hi	
salute	.vb/.nn	.hi	
salvage	.vb/.nn	.hi	
salvation	.nn	.hi	
same	.pn/.aj	.elem	
sample	.nn/.vb	.elem	
sanction	.nn/.vb	.int	
sanctuary	.nn	.hi	
sand	.nn	.elem	
sandal	.nn	.hi	
sandwich	.nn	.elem	
sandy	.aj	.hi	
sane	.aj	.hi	
sanitation	.nn	.hi	
satellite	.nn/.aj	.int	
satisfaction	.nn	.int	
satisfactory	.aj	.int	
satisfied	.aj	.hi	
satisfy	.vb	.elem	
satisfying	.aj	.hi	
saturate	.vb	.hi	
Saturday	.nn	.elem	= Sat.
sauce	.nn	.int	
saucer	.nn	.elem	
Saudi	.aj/.nn	.hi	
sausage	.nn	.int	
savage	.aj/.nn/.vb	.hi	
save	.vb	.elem	
saving	.nn	.int	
saw	.nn/.vb	.int	鋸（子）
say	.vb	.elem	
saying	.nn	.int	
scale	.nn	.elem	
scan	.vb/.nn	.int	
scandal	.nn	.hi	
scar	.nn/.vb	.hi	
scarce	.aj	.int	
scarcely	.av	.int	
scare	.vb/.nn	.int	
scarecrow	.nn	.hi	
scared	.aj	.elem	
scarf	.nn	.elem	
scary	.aj	.int	
scatter	.vb/.nn	.int	
scattered	.aj	.hi	
scenario	.nn	.hi	
scene	.nn	.elem	
scenery	.nn	.int	
scenic	.aj	.hi	
scent	.nn/.vb	.hi	
schedule	.nn/.vb	.int	
scheme	.nn/.vb	.int	
scholar	.nn	.int	
scholarship	.nn	.int	
school	.nn	.elem	
schoolboy	.nn/.aj	.int	
schoolmate	.nn	.int	
science	.nn	.elem	
scientific	.aj	.int	
scientist	.nn	.elem	
scissors	.nn	.int	
scold	.vb	.int	
scoop	.vb/.nn/.aj	.int	
scooter	.nn	.elem	
scope	.nn	.hi	
score	.vb/.nn	.elem	
scorn	.nn	.hi	
scorn	.vb	.hi	
scout	.nn	.int	
scramble	.vb/.nn	.hi	
scrap	.nn/.vb	.hi	
scrape	.vb/.nn	.hi	
scratch	.vb/.nn	.int	
scream	.vb/.nn	.int	
screen	.nn/.vb	.elem	
screw	.vb/.nn/.aj	.int	
screwdriver	.nn	.hi	
script	.nn/.vb	.hi	
scroll	.nn/.vb	.hi	
scrub	.vb/.nn	.int	
scrutiny	.nn	.hi	
sculptor	.nn	.hi	
sculpture	.vb	.hi	= sculpt
sculpture	.nn	.int	
sea	.nn	.elem	
seafood	.nn	.int	
seagull	.nn	.int	= gull
seal	.vb/.nn	.int	
seam	.nn	.hi	
search	.nn/.vb	.elem	
seaside	.nn	.int	
season	.vb	.int	調味
season 	.nn	.elem	季節
seasonable	.aj	.hi	
seasonal	.aj	.hi	
seasoned	.aj	.hi	
seasoning	.nn	.hi	
seat	.nn/.vb	.elem	
second 	.nn	.elem	秒
second 	.aj/.av/.nn	.elem	第二的 
secondary	.aj	.int	
second-hand	.aj/.av	.int	
secondly	.av	.hi	
secrecy	.nn	.hi	
secret	.aj/.nn	.elem	
secretary	.nn	.elem	
secretary-general	.nn	.hi	
section	.nn	.elem	
sector	.nn	.int	
secure	.vb/.aj	.int	
security	.nn	.int	
seduce	.vb	.hi	
seduction	.nn	.hi	
seductive	.aj	.hi	
see	.vb	.elem	
seed	.nn	.elem	
seek	.vb	.elem	
seem	.vb	.elem	
seeming	.aj	.hi	
seemingly	.av	.hi	
seesaw	.nn	.elem	蹺蹺板
segment	.nn/.vb	.hi	
segregate	.vb	.hi	
segregated	.aj	.hi	
segregation	.nn	.hi	
seize	.vb	.int	
seldom	.av	.elem	
select	.vb	.elem	
selection	.nn	.int	
selective	.aj	.hi	
self	.nn	.int	
self-esteem	.nn	.hi	
selfish	.aj	.elem	
sell	.vb	.elem	
semester	.nn	.elem	
semiconductor	.nn	.hi	
semi-final	.nn	.hi	
seminar	.nn	.hi	
senate	.nn	.hi	
senator	.nn	.hi	
send	.vb	.elem	
senior	.aj/.nn	.int	
sensation	.nn	.hi	
sensational	.aj	.hi	
sense	.nn/.vb	.elem	
sensible	.aj	.int	
sensitive	.aj	.int	
sensitivity	.nn	.hi	
sentence	.nn	.int	句子
sentence	.nn/.vb	.int	審判
sentiment	.nn	.hi	
sentimental	.aj	.hi	
separate	.aj/.vb	.elem	
separated	.aj	.hi	
separately	.av	.hi	
separation	.nn	.int	
separatism	.nn	.hi	
separatist	.aj/.nn	.hi	
September	.nn	.elem	= Sept.
sequence	.nn	.hi	
serene	.aj	.hi	
serenity	.nn	.hi	
sergeant	.nn	.hi	
serial	.nn/.aj	.hi	
series	.nn	.int	
serious	.aj	.elem	
seriously	.av	.hi	
sermon	.nn	.hi	
servant	.nn	.elem	
serve	.vb	.elem	
server	.nn	.hi	
service	.nn	.elem	
serviceman	.nn	.hi	servicewoman (女性)
serving	.nn	.hi	
session	.nn/.aj	.int	
set 	.nn	.elem	套,組
set 	.vb/.aj	.elem	放置,設立,確定的,既定的
setback	.nn	.hi	
setting	.nn	.hi	
settle	.vb	.int	
settled	.aj	.hi	
settlement	.nn	.int	
settler	.nn	.int	
set-up	.nn	.int	
seven	.nu/.pn/.nn/.aj	.elem	
seventeen	.nu/.pn/.nn/.aj	.elem	
seventy	.nu/.pn/.nn/.aj	.elem	
several	.aj/.pn	.elem	
severe	.aj	.int	
sew	.vb	.int	
sewer	.nn	.hi	
sex	.nn	.int	
sexual	.aj	.int	
sexuality	.nn	.hi	
sexy	.aj	.int	
shabby	.aj	.hi	
shade	.nn/.vb	.int	
shadow	.nn/.vb/.aj	.int	
shady	.aj	.int	
shaft	.nn/.vb	.hi	
shake	.vb/.nn	.elem	
shall	aux.	.elem	
shallow	.aj	.int	
shame	.nn/.vb	.int	
shameful	.aj	.int	
shampoo	.nn/.vb	.int	
shape	.nn/.vb	.elem	
shaped	.aj	.hi	
share	.nn/.vb	.elem	
shareholder	.nn	.hi	
shark	.nn	.elem	
sharp	.aj	.elem	
sharpen	.vb	.int	
shatter	.vb	.hi	
shave	.vb	.int	
shaver	.nn	.int	
she	.pn	.elem	
shear	.vb/.nn	.hi	
shed	.nn/.vb	.hi	
sheep	.nn	.elem	
sheer	.aj/.av/.vb	.hi	
sheet	.nn	.elem	
shelf	.nn	.elem	
shell	.nn	.int	
shelter	.nn/.vb	.int	
shepherd	.nn/.vb	.int	
sheriff	.nn	.hi	
sherry	.nn	.hi	
shield	.nn/.vb	.hi	
shift	.vb/.nn	.int	
shilling	.nn	.hi	
shine	.vb	.elem	
shining	.aj	.hi	
shiny	.aj	.int	
ship	.nn	.elem	船
ship	.vb	.elem	以船託運
shipment	.nn	.hi	
shipping	.nn	.hi	
shirt	.nn	.elem	
shiver	.vb/.nn	.hi	
shock	.nn/.vb	.elem	
shocking	.aj	.hi	
shoe	.nn	.elem	
shoot	.vb/.nn	.elem	
shooting	.nn	.hi	
shop 	.nn	.elem	= store 商店
shop 	.vb	.elem	購買
shopkeeper	.nn	.int	
shoplift	.vb	.hi	
shopping	.nn	.int	
shore	.nn	.elem	
short	.aj	.elem	
shortage	.nn	.int	
shortcoming	.nn	.int	
shortcut	.nn	.int	
shorten	.vb	.int	
shortly	.av	.int	
shorts	.nn	.int	
short-sighted	.aj	.int	
short-term	.aj/.nn	.hi	
shot	.nn	.elem	
should	aux.	.elem	
shoulder	.nn	.elem	
shout	.vb/.nn	.elem	
shove	.vb/.nn	.hi	
shovel	.nn/.vb	.int	
show	.vb/.nn	.elem	
shower	.nn/.vb	.elem	
shred	.vb/.nn	.hi	
shrewd	.aj	.hi	
shriek	.vb/.nn	.hi	
shrimp	.nn	.elem	
shrine	.nn	.hi	
shrink	.vb/.nn	.int	
shrub	.nn	.hi	
shrug	.vb/.nn	.int	
shudder	.vb/.nn	.hi	
shuffle	.vb/.nn	.hi	
shun	.vb	.hi	
shut	.vb	.elem	
shutter	.nn/.vb	.hi	
shuttle	.nn/.vb	.int	
shy	.aj	.elem	
sick	.aj	.elem	
sickness	.nn	.int	
side	.nn	.elem	
side-effect	.nn	.hi	
sidewalk	.nn	.elem	= pavement (British English)
sideways	.av/.aj	.hi	
siege	.nn	.hi	
sigh	.vb/.nn	.int	
sight	.nn	.elem	
sightseeing	.nn	.int	
sign 	.vb	.elem	簽名,簽約
sign 	.nn	.elem	徵兆,標示
signal	.nn/.vb/.aj	.int	
signature	.nn	.int	
significance	.nn	.int	
significant	.aj	.int	
signify	.vb	.hi	
silence	.nn	.elem	
silent	.aj	.elem	
silicon	.nn	.hi	
silk	.nn	.int	
silkworm	.nn	.hi	
silly	.aj	.elem	
silver	.nn/.aj	.elem	
similar	.aj	.elem	
similarity	.nn	.int	
simmer	.vb/.nn	.hi	
simple	.aj	.elem	
simplicity	.nn	.hi	
simplify	.vb	.int	
simply	.av	.elem	
simulate	.vb	.hi	
simulation	.nn	.hi	
simultaneous	.aj	.hi	
sin	.nn/.vb	.int	
since	.cj/.pr/.av	.elem	
sincere	.aj	.elem	
sincerely	.av	.int	
sincerity	.nn	.hi	
sing	.vb	.elem	
Singapore	.nn	.elem	
Singaporean	.aj/.nn	.int	
singer	.nn	.elem	
singing	.nn	.int	
single	.aj/.nn	.elem	
singular	.aj	.int	
sinister	.aj	.hi	
sink 	.nn	.elem	水槽,流理槽
sink 	.vb	.elem	沉沒
sip	.vb/.nn	.int	
sir	.nn	.elem	
sister	.nn	.elem	
sit	.vb	.elem	
sit-down	.nn	.hi	
sit-down	.aj	.hi	
site	.nn	.int	
sit-in	.nn	.hi	
situated	.aj	.hi	
situation	.nn	.int	
six	.nu/.pn/.nn/.aj	.elem	
sixteen	.nu/.pn/.nn/.aj	.elem	
sixty	.nu/.pn/.nn/.aj	.elem	
size	.nn	.elem	
skate	.nn/.vb	.elem	
skating	.nn	.int	
skeleton	.nn/.aj	.hi	
skeptical	.aj	.hi	= sceptical (British English), skeptic, sceptic
sketch	.nn/.vb	.int	
ski	.nn/.vb	.elem	
skiing	.nn	.int	
skill	.nn	.elem	
skilled	.aj	.hi	
skillful	.aj	.elem	= skilful (British English)
skim	.vb/.nn	.int	
skin	.nn	.elem	
skinny	.aj	.elem	
skip	.vb/.nn	.int	
skipper	.nn/.vb	.hi	
skirt	.vb	.hi	包圍，裝邊
skirt 	.nn	.elem	裙子
skull	.nn	.hi	
sky	.nn	.elem	
skyscraper	.nn	.int	
slack	.nn	.hi	
slack	.vb	.hi	
slack	.aj	.hi	
slam	.vb/.nn	.hi	
slang	.nn	.int	
slap	.vb/.nn	.hi	
slap	.av	.hi	
slash	.vb/.nn	.hi	
slate	.nn/.vb	.hi	
slaughter	.vb/.nn	.hi	
slave	.nn/.vb	.int	
slavery	.nn	.int	
slay	.vb	.hi	
sled	.nn/.vb	.hi	= sledge (British English)
sleep	.vb/.nn	.elem	
sleepy	.aj	.elem	
sleeve	.nn	.int	
sleigh	.nn/.vb	.hi	
slender	.aj	.elem	
slice	.nn/.vb	.int	
slick	.nn	.hi	
slick	.vb/.aj	.hi	
slide	.vb/.nn	.elem	
slight	.aj/.vb/.nn	.int	
slightly	.av	.int	
slim	.aj	.elem	
slip	.vb/.nn	.elem	
slippers	.nn	.elem	
slippery	.aj	.int	
slit	.vb/.nn	.hi	
slogan	.nn	.int	
slope	.nn/.vb	.int	
sloppy	.aj	.hi	
slot	.nn/.vb	.hi	
slow	.aj/.vb/.av	.elem	
slum	.nn/.vb	.hi	
slump	.nn	.hi	
slump	.vb	.hi	
sly	.aj	.hi	
smack	.vb/.nn/.av	.hi	
small	.aj	.elem	
smallpox	.nn	.hi	
sm.ar	.aj	.elem	
smash	.vb/.nn	.hi	
smell	.nn/.vb	.elem	
smile	.vb/.nn	.elem	
smog	.nn	.int	
smoke	.nn/.vb	.elem	
smoking	.nn/.aj	.int	
smoky	.aj	.int	
smooth	.aj/.vb	.int	
smother	.vb	.hi	
smuggle	.vb	.hi	
snack	.nn/.vb	.elem	
snail	.nn	.elem	
snake	.nn	.elem	
snap	.vb/.aj/.nn	.int	
snare	.nn/.vb	.hi	
snarl	.vb/.nn	.hi	
snatch	.vb/.nn	.hi	
sneak	.vb	.int	
sneakers	.nn	.elem	
sneaky	.aj	.elem	
sneer	.nn/.vb	.hi	
sneeze	.vb/.nn	.int	
sniff	.vb/.nn	.hi	
snore	.nn/.vb	.hi	
snorkel	.vb/.nn	.hi	
snort	.nn/.vb	.hi	
snow	.nn/.vb	.elem	
snowman	.nn	.int	
snowy	.aj	.elem	
so 	.av	.elem	如此,這般
so 	.cj	.elem	所以, ...也
soak	.vb/.nn	.hi	
soap	.nn/.vb	.elem	
soar	.vb	.hi	
sob	.vb/.nn	.int	
sober	.aj/.vb	.hi	
so-called	.aj	.hi	
soccer	.nn	.elem	
sociable	.aj	.int	
social	.aj	.elem	
socialism	.nn	.hi	
socialist	.aj/.nn	.hi	
socialize	.vb	.hi	= socialise
society	.nn	.elem	
sociology	.nn	.hi	
socket	.nn	.int	
socks	.nn	.elem	
soda	.nn	.elem	
sodium	.nn/.aj	.hi	
sofa	.nn	.elem	
soft	.aj	.elem	
softball	.nn	.int	
soften	.vb	.hi	
software	.nn	.int	
soil	.nn/.vb	.int	
solar	.aj	.int	
soldier	.nn	.elem	
sole	.aj/.nn/.vb	.hi	
solely	.av	.hi	
solemn	.aj	.hi	
solicitor	.nn	.hi	
solid	.aj/.nn	.int	
solidarity	.nn	.hi	
solitary	.aj/.nn	.hi	
solitude	.nn	.hi	
solo	.nn/.aj/.av	.hi	
soluble	.aj	.hi	
solution	.nn	.elem	
solve	.vb	.elem	
some	.pn/.de	.elem	
somebody	.pn	.elem	= someone
someday	.av	.hi	
somehow	.av	.int	
someone	.pn	.elem	= somebody
something	.pn	.elem	
sometime	.av/.aj	.int	
sometimes	.av	.elem	
somewhat	.av	.int	
somewhere	.av	.elem	
son	.nn	.elem	
song	.nn	.elem	
soon	.av	.elem	
soothe	.vb	.hi	
sophisticated	.aj	.hi	
sophomore	.nn	.hi	
sore	.aj/.nn	.elem	
sorrow	.nn	.int	
sorrowful	.aj	.hi	
sorry	.aj	.elem	
sort	.nn	.elem	
sort	.vb	.elem	
soul	.nn	.elem	
sound	.aj	.int	健康的,狀況良好的
sound 	.nn/.vb	.elem	聲音,聽起來
soundtrack	.nn	.hi	
soup	.nn	.elem	
sour	.aj	.elem	
source	.nn	.elem	
south	.nn/.av/.aj	.elem	
south-east	.nn/.av/.aj	.int	
southern	.aj	.elem	
south-west	.nn/.av/.aj	.int	
souvenir	.nn	.int	
sovereign	.aj/.nn	.hi	
sovereignty	.nn	.hi	
sow	.vb/.nn	.int	
soybean	.nn	.int	soya bean/soy
soy-sauce	.nn	.elem	
space	.nn	.elem	
spacecraft	.nn	.int	
spacious	.aj	.hi	
spade	.nn	.int	
spaghetti	.nn	.elem	
span	.nn/.vb	.hi	
spare	.aj/.vb/.nn	.int	
spark	.nn/.vb	.int	
sparkle	.vb/.nn	.int	
sparrow	.nn	.int	
spatial	.aj	.hi	
speak	.vb	.elem	
speaker	.nn	.elem	
spear	.nn/.vb	.int	
special	.aj/.nn	.elem	
specialist	.nn	.hi	
specialize	.vb	.hi	= specialise (British English)
specialized	.aj	.int	
specially	.av	.hi	= especially
specialty	.nn	.hi	= speciality (British English)
species	.nn	.int	
specific	.aj	.int	
specifically	.av	.hi	
specification	.nn	.hi	
specify	.vb	.hi	
specimen	.nn	.hi	
spectacle	.nn	.hi	
spectacular	.aj/.nn	.hi	
spectator	.nn	.int	
spectrum	.nn	.hi	
speculate	.vb	.hi	
speculation	.nn	.hi	
speech	.nn	.elem	
speed	.nn/.vb	.elem	
spell	.nn	.int	咒語
spell 	.vb	.elem	拼字
spelling	.nn	.elem	
spend	.vb	.elem	
sperm	.nn	.hi	
sphere	.nn	.hi	
spice	.nn/.vb	.int	
spicy	.aj	.int	
spider	.nn	.elem	
spike	.nn/.vb	.hi	
spill	.vb/.nn	.int	
spin	.vb/.nn	.int	
spinach	.nn	.int	
spine	.nn	.hi	
spiral	.nn/.aj/.vb	.hi	
spire	.nn	.hi	
spirit	.nn	.elem	
spiritual	.aj	.int	
spit	.vb/.nn	.int	
spite	.nn	.int	
splash	.vb/.nn	.int	
splendid	.aj	.int	
splendor	.nn	.hi	= splendour (British English)
split	.vb/.nn/.aj	.int	
spoil	.vb/.nn	.int	
spokesman	.nn	.int	
sponge	.nn/.vb	.hi	
sponsor	.vb/.nn	.int	
sponsorship	.nn	.hi	
spontaneous	.aj	.hi	
spoon	.nn	.elem	
sport	.nn	.elem	
sporting	.aj	.hi	
sportsman	.nn	.int	
sportsmanship	.nn	.int	
spot	.nn/.vb	.elem	
spotlight	.nn/.vb	.hi	
spouse	.nn	.hi	
sprain	.vb/.nn	.hi	
sprawl	.vb/.nn	.hi	
spray	.nn/.vb	.int	
spread	.vb/.nn	.elem	
spring	.vb	.hi	跳躍，反彈
spring 	.nn	.elem	春天,泉水
sprinkle	.vb/.nn	.int	
sprint	.nn/.vb	.hi	
spur	.vb/.nn	.hi	
spy	.nn/.aj/.vb	.int	
squad	.nn	.hi	
square	.nn/.aj	.elem	
squash	.vb/.nn	.hi	
squat	.vb/.aj/.nn	.hi	
squeeze	.vb/.nn	.int	
squirrel	.nn	.int	
stab	.vb/.nn	.int	
stability	.nn	.hi	
stabilize	.vb	.hi	
stable	.aj	.int	穩定的
stable	.nn	.int	馬房
stack	.nn/.vb	.hi	
stadium	.nn	.int	
staff	.nn/.vb	.int	
stage	.nn	.elem	
stagger	.vb/.nn	.hi	
staggering	.aj	.hi	
stain	.nn/.vb	.hi	
stainless	.aj	.hi	
staircase	.nn	.int	
stairs	.nn	.elem	
stake	.nn/.vb	.int	
stale	.aj/.vb	.hi	
stalk	.nn/.vb	.hi	
stall	.nn	.hi	
stall	.vb	.hi	
stammer	.vb/.nn	.hi	
stamp	.nn/.vb	.elem	
stance	.nn	.hi	
stand	.vb/.nn	.elem	
standard	.nn/.aj	.elem	
standpoint	.nn	.hi	
stand-up	.aj	.hi	
stanza	.nn	.hi	
staple	.nn/.vb	.hi	
staple	.aj	.hi	
stapler	.nn	.hi	
star	.nn/.vb	.elem	
starch	.nn/.vb	.hi	
stare	.vb/.nn	.int	
stark	.aj/.av	.hi	
st.ar	.vb/.nn	.elem	
st.arer	.nn	.hi	
st.arle	.vb	.hi	
st.arling	.aj	.hi	
starvation	.nn	.int	
starve	.vb	.int	
state	.nn/.vb/.aj	.int	
state 	.vb	.int	陳述，宣佈
state 	.nn	.elem	州,國家
statement	.nn	.int	
statesman	.nn	.hi	
static	.nn	.hi	
static	.aj	.hi	
station	.nn	.elem	
stationary	.aj	.hi	
stationery	.nn	.elem	
statistic	.nn	.hi	
statistical	.aj	.hi	
statistician	.nn	.hi	
statistics	.nn	.hi	
statue	.nn	.int	
stature	.nn	.hi	
status	.nn	.int	
statutory	.aj	.hi	
stay	.vb/.nn	.elem	
steady	.aj/.vb	.int	
steak	.nn	.elem	
steal	.vb	.elem	
steam	.nn/.vb	.elem	
steamer	.nn	.hi	
steel	.nn/.vb	.int	
steep	.vb	.hi	浸泡
steep	.aj	.int	陡峭的
steer	.vb/.nn	.int	
stem	.vb/.nn	.int	
step	.nn/.vb	.elem	
stepchild	.nn	.hi	
stepfather	.nn	.int	
stepmother	.nn	.int	
stereo	.aj/.nn	.int	
stereotype	.nn/.vb	.hi	
sterling	.nn	.hi	
sterling	.aj	.hi	
stern	.nn	.hi	
stern	.aj	.hi	
stew	.vb/.nn	.hi	
steward	.nn	.hi	= stewardess/attendant
stick	.vb	.hi	
stick 	.nn	.elem	棍子
sticky	.aj	.int	
stiff	.aj/.av	.int	
still	.aj/.vb/.nn	.hi	靜止；蒸餾器；電影之靜態畫面
still 	.av	.elem	仍然,更加
stimulate	.vb	.int	
stimulating	.aj	.hi	
stimulation	.nn	.hi	
stimulus	.nn	.hi	
sting	.vb/.nn	.int	
stingy	.aj	.elem	
stink	.vb/.nn	.hi	
stir	.vb/.nn	.int	
stitch	.nn/.vb	.int	
stock	.nn/.vb/.aj	.int	
stocking	.nn	.int	
stomach	.nn	.elem	= tummy
stomachache	.nn	.elem	
stone	.nn	.elem	
stool	.nn	.int	
stoop	.vb/.nn	.hi	
stop	.vb/.nn	.elem	
storage	.nn	.hi	
store 	.nn	.elem	商店
store 	.vb	.elem	貯存
storey	.nn	.int	= story (American English) 樓層
storm	.nn	.elem	
stormy	.aj	.elem	
story 	.nn	.elem	故事,樓層（=floor）
storyteller	.nn	.int	
stout	.aj	.hi	
stove	.nn	.elem	
straight	.av/.aj	.elem	
straighten	.vb	.hi	
straightforward	.aj	.hi	
strain	.nn/.vb	.hi	
strained	.aj	.hi	
strait	.nn	.hi	
strange	.aj	.elem	
stranger	.nn	.elem	
strangle	.vb	.hi	
strap	.nn/.vb	.hi	
strategic	.aj	.hi	
strategy	.nn	.int	
straw	.nn	.elem	
strawberry	.nn	.elem	
stray	.vb/.aj/.nn	.hi	
streak	.nn	.hi	
streak	.vb	.hi	
stream	.nn	.elem	
street	.nn	.elem	
strength	.nn	.int	
strengthen	.vb	.int	
stress	.vb/.nn	.elem	
stretch	.vb/.nn/.aj	.int	
strict	.aj	.int	
stride	.vb/.nn	.hi	
strike 	.vb/.nn	.elem	敲打;罷工
striker	.nn	.hi	
striking	.aj	.hi	
string	.nn/.vb	.int	
strip	.nn/.vb	.int	
stripe	.nn	.hi	
strive	.vb	.int	
stroke	.nn/.vb	.int	
stroll	.vb/.nn	.hi	
strong	.aj	.elem	
structural	.aj	.hi	
structure	.nn/.vb	.int	
struggle	.nn/.vb	.elem	
stubborn	.aj	.int	
stuck	.aj	.hi	
student	.nn	.elem	
studio	.nn	.int	
study	.nn/.vb	.elem	
stuff	.nn/.vb	.int	
stumble	.vb/.nn	.hi	
stump	.nn	.hi	
stump	.vb	.hi	
stun	.vb	.hi	
stunning	.aj	.hi	
stunt	.nn	.hi	
stunt	.vb	.hi	
stupid	.aj	.elem	
sturdy	.aj	.hi	
stutter	.vb/.nn	.hi	
style	.nn	.elem	
stylish	.aj	.hi	
stylistic	.aj	.hi	
sub	.nn/.vb	.hi	
sub	.vb	.hi	
subject	.aj/.vb	.int	統治,使服從;隸屬的 (P)
subject 	.nn	.elem	主題,科目,主詞 (P)
subjective	.aj	.hi	
submarine	.nn/.aj	.int	
submerge	.vb	.hi	
submersion	.nn	.hi	
submit	.vb	.hi	
subordinate	.nn/.aj/.vb	.hi	
subscribe	.vb	.hi	
subscription	.nn	.hi	
subsequent	.aj	.hi	
subsidiary	.nn/.aj	.hi	
subsidize	.vb	.hi	
subsidy	.nn	.hi	
substance	.nn	.int	
substantial	.aj	.hi	
substantially	.av	.hi	
substitute	.nn/.vb	.int	
substitution	.nn	.hi	
subtle	.aj	.hi	
subtlety	.nn	.hi	
subtract	.vb	.int	
suburb	.nn	.int	
suburban	.aj	.hi	
subway	.nn	.elem	= underground=tube (British English)=MRT=metro
succeed	.vb	.elem	
success	.nn	.elem	
successful	.aj	.elem	
succession	.nn	.hi	
successive	.aj	.hi	
successor	.nn	.hi	
such	.aj/.pn	.elem	
suck	.vb	.int	
sudden	.aj/.nn	.elem	
suddenly	.av	.elem	
sue	.vb	.hi	
suffer	.vb	.int	
suffering	.nn	.int	
sufficient	.aj	.int	
suffocate	.vb	.hi	
sugar	.nn	.elem	
suggest	.vb	.elem	
suggestion	.nn	.int	
suicide	.nn	.int	
suit 	.nn	.elem	套裝
suit 	.vb	.elem	適合
suitable	.aj	.int	
suitcase	.nn	.int	
suite	.nn	.hi	
sulfur	.nn	.hi	= sulphur (British English)
sum	.nn/.vb	.int	
summarize	.vb	.int	
summary	.nn	.int	
summer	.nn	.elem	
summit	.nn	.int	
summon	.vb	.hi	
sun	.nn	.elem	
sunbathe	.vb	.int	
Sunday	.nn	.elem	= Sun.
sunlight	.nn	.int	
sunny	.aj	.elem	
sunrise	.nn	.int	
sunset	.nn	.int	
sunshine	.nn	.hi	
super	.aj/.av	.elem	
superb	.aj	.int	
superficial	.aj	.hi	
superintendent	.nn	.hi	
superior	.aj/.nn	.int	
superiority	.nn	.hi	
supermarket	.nn	.elem	
superpower	.nn	.hi	
supersonic	.aj	.hi	
superstition	.nn	.hi	
superstitious	.aj	.hi	
supervise	.vb	.hi	
supervision	.nn	.hi	
supervisor	.nn	.int	
supper	.nn	.elem	= dinner
supplement	.vb/.nn	.hi	
supplementary	.aj	.hi	
supplier	.nn	.hi	
supply	.nn/.vb	.elem	
support	.nn/.vb	.elem	
supporter	.nn	.int	
supportive	.aj	.hi	
suppose	.vb	.int	
supposed 	aux.	.int	be supposed to (P)
supposed 	.aj	.int	(P)
suppress	.vb	.hi	
supreme	.aj	.int	
sure	.aj/.av	.elem	
surely	.av	.int	
surf	.nn/.vb	.elem	
surface	.nn	.elem	
surfing	.nn	.int	
surge	.nn/.vb	.hi	
surgeon	.nn	.int	
surgery	.nn	.int	
surgical	.aj	.hi	
surpass	.vb	.hi	
surplus	.nn/.aj	.hi	
surprise	.nn/.vb	.elem	
surprised	.aj	.elem	
surrender	.vb/.nn	.int	
surround	.vb/.nn	.int	
surroundings	.nn	.int	
surveillance	.nn	.hi	
survey	.nn/.vb	.int	
survival	.nn	.int	
survive	.vb	.elem	
survivor	.nn 	.int	
susceptible	.aj	.hi	
suspect	.vb/.nn/.aj	.int	
suspend	.vb	.int	
suspense	.nn	.hi	
suspension	.nn	.int	
suspicion	.nn	.int	
suspicious	.aj	.int	
sustain	.vb	.hi	
swallow	.vb/.nn	.hi	吞嚥
swallow 	.nn	.elem	燕子
swamp	.nn	.hi	
swamp	.vb	.hi	
swan	.nn	.elem	
swap	.vb/.nn	.hi	
swarm	.nn/.vb	.hi	
sway	.vb/.nn	.hi	
swear	.vb	.int	
sweat	.nn/.vb	.int	
sweater	.nn	.elem	
sweep	.vb	.elem	
sweet	.aj/.nn	.elem	noun = candy
swell	.vb/.nn	.int	
swift	.aj/.nn	.int	
swim	.vb	.elem	
swimming	.nn	.int	
swimsuit	.nn	.elem	
swing	.vb/.nn	.elem	
switch	.vb/.nn	.int	
swollen	.aj	.hi	
sword	.nn	.int	
syllable	.nn	.int	
syllabus	.nn	.hi	
symbol	.nn	.elem	
symbolic	.aj	.hi	= symbolical
symbolism	.nn	.hi	
symbolize	.vb	.int	
symmetrical	.aj	.hi	
symmetry	.nn	.hi	
sympathetic	.aj	.int	
sympathize	.vb	.int	
sympathy	.nn	.int	
symphony	.nn	.int	
symposium	.nn	.hi	
symptom	.nn	.int	
syndicate	.nn/.vb	.hi	
syndrome	.nn	.hi	
synonym	.nn	.hi	
synonymous	.aj	.hi	
syntactic	.aj	.hi	
syntax	.nn	.hi	
synthesis	.nn	.hi	
synthetic	.aj/.nn	.hi	
syrup	.nn	.int	
system	.nn	.elem	
systematic	.aj	.int	
systematical	.aj	.hi	
table	.nn	.elem	
tablecloth	.nn	.int	
tablespoon	.nn	.hi	
tablet	.nn	.int	
tableware	.nn	.hi	
tabloid	.nn	.hi	
taboo	.nn	.hi	
tack	.nn/.vb	.int	
tackle	.vb/.nn	.hi	
taco	.nn	.hi	
tact	.nn	.hi	
tactic	.nn	.hi	
tactical	.aj	.hi	
tactics	.nn	.hi	
tag	.nn/.vb	.int	
Taichung	.nn	.elem	
tail	.nn	.elem	
tailor	.nn/.vb	.int	
tailor-made	.aj	.hi	
Tainan	.nn	.elem	
Taiwan	.nn	.elem	
Taiwanese	.aj/.nn	.elem	
take	.vb	.elem	
takeaway	.nn	.hi	 = carryout, takeout
takeover	.nn	.hi	
tale	.nn	.int	
talent	.nn	.elem	
talented	.aj	.int	
talk	.vb/.nn	.elem	
talkative	.aj	.elem	
tall	.aj	.elem	
tally	.nn/.vb	.hi	
tame	.aj/.vb	.int	
tan	.nn/.vb	.hi	
tangerine	.nn	.elem	
tangle	.nn/.vb	.hi	
tango	.nn	.hi	
tank	.nn	.elem	
tanker	.nn	.hi	
tap	.vb/.nn	.int	
tape	.nn/.vb	.elem	
tar	.nn/.vb	.hi	
tardy	.aj	.hi	
target	.nn/.vb	.elem	
tariff	.nn	.hi	
t.ar	.nn	.hi	
task	.nn	.elem	
taste	.nn/.vb	.elem	
tasteful	.aj	.hi	
tasteless	.aj	.hi	
tasty	.aj	.int	
tattoo	.nn	.hi	
taunt	.nn/.vb	.hi	
tavern	.nn	.hi	
tax	.nn/.vb	.int	
taxation	.nn	.hi	
tax-free	.aj	.hi	
taxi	.nn	.elem	= taxicab = cab
taxpayer	.nn	.hi	
tea	.nn	.elem	
teach	.vb	.elem	
teacher	.nn	.elem	
Teacher's Day	.nn	.elem	
team	.nn	.elem	
team-mate	.nn	.hi	
teamwork	.nn	.hi	
teapot	.nn	.elem	
tear 	.nn	.elem	眼淚 (P)
tear 	.vb	.elem	撕裂 (P)
tease	.vb/.nn	.int	
teaspoon	.nn	.hi	
technical	.aj	.int	
technician	.nn	.int	
technique	.nn	.int	
technological	.aj	.int	
technology	.nn	.int	
tedious	.aj	.hi	
teen	.nn/.aj	.int	
teenage	.aj	.int	
teenager	.nn	.elem	
teens	.nn	.hi	
telecommunications	.nn	.hi	
telegram	.nn	.int	
telegraph	.nn/.vb	.int	
telephone	.nn/.vb	.elem	= phone
telescope	.nn	.int	
televise	.vb	.int	
television	.nn	.elem	= TV
tell	.vb	.elem	
teller	.nn	.hi	
temper	.nn/.vb	.int	
temperament	.nn	.hi	
temperature	.nn	.elem	
tempest	.nn	.hi	
temple	.nn	.elem	
tempo	.nn	.hi	
temporary	.aj	.int	
tempt	.vb	.hi	
temptation	.nn	.hi	
tempted	.aj	.hi	
ten	.nu/.pn/.nn/.aj	.elem	
tenant	.nn	.int	
tend	.vb	.int	
tendency	.nn	.int	
tender	.aj	.int	
tennis	.nn	.elem	
tense	.aj/.vb	.int	
tension	.nn	.int	
tent	.nn	.elem	
tentative	.aj	.hi	
term	.nn/.vb	.elem	
terminal	.nn/.aj	.int	
terminate	.vb	.hi	
termination	.nn	.hi	
terminology	.nn	.hi	
termite	.nn	.hi	
terrace	.nn	.hi	
terrain	.nn	.hi	
terrestrial	.aj	.hi	
terrible	.aj	.elem	
terrific	.aj	.elem	
terrified	.aj	.hi	
terrify	.vb	.int	
terrifying	.aj	.hi	
territorial	.aj/.nn	.hi	
territory	.nn	.int	
terror	.nn	.int	
terrorism	.nn	.hi	
terrorist	.nn	.hi	
tertiary	.aj	.hi	
test	.nn/.vb	.elem	
testament	.nn	.hi	
testify	.vb	.hi	
testimony	.nn	.hi	
text	.nn	.int	
textbook	.nn	.elem	
textile	.nn	.hi	
textual	.aj	.hi	
texture	.nn	.hi	
than	.cj/.pr	.elem	
thank	.vb/.nn	.elem	
thankful	.aj	.int	
Thanksgiving	.nn	.elem	= Thanksgiving Day
that	.cj/.pn/.aj/.av	.elem	
the	.ar	.elem	
theater	.nn	.elem	= theatre (British English)
theatrical	.aj	.hi	
theft	.nn	.int	
their	.de	.elem	
theirs	.pn	.int	
them	.pn	.elem	
theme	.nn	.int	
themselves	.pn	.elem	
then	.av/.aj	.elem	
theoretical	.aj	.hi	
theory	.nn	.int	
therapist	.nn	.hi	
therapy	.nn	.int	
there	.av/.pn	.elem	
thereafter	.av	.hi	
thereby	.av	.hi	
therefore	.av	.elem	
thermal	.aj/.nn	.hi	
thermometer	.nn	.hi	
thermos	.nn	.hi	
thesaurus	.nn	.hi	
these	.pn/.aj	.elem	
thesis	.nn	.hi	
they	.pn	.elem	
thick	.aj	.elem	
thicken	.vb	.hi	
thickness	.nn	.hi	
thief	.nn	.elem	
thigh	.nn	.hi	
thin	.aj	.elem	
thing	.nn	.elem	
think	.vb	.elem	
thinking	.nn/.aj	.int	
third	.aj/.av/.nn	.elem	
thirst	.nn/.vb	.int	
thirsty	.aj	.elem	
thirteen	.nu/.pn/.nn/.aj	.elem	
thirty	.nu/.pn/.nn/.aj	.elem	
this	.pn/.aj/.av	.elem	
thorn	.nn	.hi	
thorny	.aj	.hi	
thorough	.aj	.int	
those	.pn/.aj	.elem	
though	.cj/.av	.elem	
thought	.nn	.elem	
thoughtful	.aj	.int	
thousand	.nu/.pn/.nn	.elem	
thread	.nn/.vb	.int	
threat	.nn	.int	
threaten	.vb	.int	
three	.nu/.pn/.nn/.aj	.elem	
threshold	.nn	.hi	
thrift	.nn	.hi	
thrifty	.aj	.hi	
thrill	.nn/.vb	.hi	
thriller	.nn	.hi	
thrive	.vb	.hi	
throat	.nn	.elem	
throb	.vb/.nn	.hi	
throne	.nn	.hi	
throng	.nn/.vb	.hi	
through	.pr/.av	.elem	
throughout	.pr	.elem	
throw	.vb	.elem	
thrust	.vb/.nn	.hi	
thumb	.nn	.elem	
thunder	.nn/.vb	.elem	
thunderbolt	.nn	.hi	
thunderous	.aj	.hi	
thunderstorm	.nn	.int	
Thursday	.nn	.elem	= Thurs./Thur.
thus	.av	.elem	
tick	.nn/.vb	.hi	
ticket	.nn	.elem	
tickle	.vb	.int	
tide	.nn	.int	
tidy	.aj/.vb	.elem	
tie 	.nn	.elem	領帶
tie 	.vb	.elem	綁
tiger	.nn	.elem	
tight	.aj/.av	.int	
tighten	.vb	.int	
tile	.nn/.vb	.hi	
till	.pr/.cj	.elem	= until
tilt	.vb/.nn	.hi	
timber	.nn	.int	
time	.nn/.vb	.elem	
timeless	.aj	.hi	
timely	.aj	.hi	
time-out	.nn	.hi	
timer	.nn	.hi	
timetable	.nn/.vb	.int	
timid	.aj	.int	
timing	.nn	.hi	
tin	.nn	.int	
tinkle	.vb	.hi	
tint	.nn	.hi	
tiny	.aj	.elem	
tip	.nn/.vb	.elem	頂端;(給)小費
tiptoe	.vb/.nn	.int	
tire	.nn	.int	= tyre (British English) 輪胎
tire	.vb	.int	使疲倦
tired	.aj	.elem	
tiresome	.aj	.int	
tiring	.aj	.int	
tissue	.nn	.int	
title	.nn	.elem	
to 	.pr/inf.	.elem	
toad	.nn	.hi	
toady	.nn/.vb	.hi	
toast 	.nn/.vb	.elem	吐司,烤吐司;乾杯
tobacco	.nn	.int	
today	.av/.nn	.elem	
toddle	.vb	.hi	
toddler	.nn	.hi	
toe	.nn	.elem	
tofu	.nn	.elem	= bean curd
together	.av/.aj	.elem	
toil	.vb/.nn	.hi	
toilet	.nn	.elem	
token	.aj/.nn	.hi	
tolerable	.aj	.int	
tolerance	.nn	.int	
tolerant	.aj	.int	
tolerate	.vb	.int	
toll	.nn/.vb	.hi	
tollbooth	.nn	.hi	
tollway	.nn	.hi	
tomato	.nn	.elem	
tomb	.nn	.int	
tomorrow	.av/.nn	.elem	
ton	.nn	.int	
tone	.nn/.vb	.int	
tongue	.nn	.elem	
tonic	.nn	.hi	
tonight	.av/.nn	.elem	
tonne	.nn	.hi	= 1,000 kilograms
too	.av	.elem	
tool	.nn	.elem	
tooth	.nn	.elem	
toothache	.nn	.elem	
toothbrush	.nn	.elem	
toothpaste	.nn	.int	
top	.nn/.aj/.vb	.elem	
topic	.nn	.elem	
topical	.aj	.hi	
topping	.nn	.hi	
topple	.vb	.hi	
torch	.nn/.vb	.int	
torment	.nn/.vb	.hi	
tornado	.nn	.int	
torrent	.nn	.hi	
tortoise	.nn	.int	
torture	.vb/.nn	.hi	
toss	.vb/.nn	.int	
total	.aj/.nn/.vb	.elem	
touch	.vb/.nn	.elem	
touching	.aj	.hi	
touchy	.aj	.hi	
tough	.aj/.nn/.vb	.int	
tour	.nn/.vb	.elem	
tourism	.nn	.int	
tourist	.nn	.int	
tournament	.nn	.hi	
tow	.vb/.nn	.int	
toward	.pr	.elem	= towards
towel	.nn	.elem	
tower	.nn	.elem	
town	.nn	.elem	
township	.nn	.hi	
toxic	.aj	.hi	
toy	.nn	.elem	
trace	.vb/.nn	.elem	
track	.nn	.elem	
track	.vb	.elem	
tract	.nn	.hi	
tractor	.nn	.hi	
trade	.nn/.vb	.elem	
trade-in	.nn	.hi	
trademark	.nn	.int	
trade-off	.nn	.hi	
trader	.nn	.int	
tradition	.nn	.elem	
traditional	.aj	.elem	
traffic	.nn	.elem	
tragedy	.nn 	.int	
tragic	.aj	.int	
trail	.nn/.vb	.int	
trailer	.nn	.hi	
train 	.nn	.elem	火車
train 	.vb	.elem	訓練
trainee	.nn	.hi	
training	.nn	.int	
trait	.nn	.hi	
traitor	.nn	.hi	
traitorous	.aj	.hi	
tramp	.vb/.nn	.hi	
trample	.vb/.nn	.hi	
tranquil	.aj	.hi	
tranquilize	.vb	.hi	
tranquilizer	.nn	.hi	
transaction	.nn	.hi	
transcend	.vb	.hi	
transcendent	.aj	.hi	
transcribe	.vb	.hi	
transcript	.nn	.hi	
transcription	.nn	.hi	
transfer	.nn/.vb	.int	
transform	.vb	.int	
transformation	.nn	.hi	
transformer	.nn	.hi	
transient	.aj/.nn	.hi	= transitory
transistor	.nn	.hi	
transit	.nn/.aj	.hi	
transition	.nn	.hi	
translate	.vb	.int	
translation	.nn	.int	
translator	.nn	.int	
transmission	.nn	.hi	
transmit	.vb	.hi	
transparency	.nn	.hi	
transparent	.aj	.hi	
transplant	.nn/.vb	.int	
transport	.nn/.vb	.int	
transportation	.nn	.int	
trap	.vb/.nn	.elem	
trash	.nn/.vb	.elem	
trauma	.nn	.hi	
traumatic 	.aj	.hi	
travel	.vb/.nn	.elem	
traveler	.nn	.int	= traveller (British English)
traveling	.aj	.int	= travelling (British English)
traverse	.vb/.nn	.hi	
tray	.nn	.int	
treacherous	.aj	.hi	
tread	.vb/.nn	.hi	
treason	.nn	.hi	
treasure	.nn/.vb	.elem	
treasury	.nn	.hi	
treat	.vb/.nn	.elem	
treatment	.nn	.elem	
treaty	.nn	.int	
tree	.nn	.elem	
trek	.vb/.nn	.hi	
tremble	.vb/.nn	.int	
tremendous	.aj	.int	
tremor	.nn	.hi	
trench	.nn/.vb	.hi	
trend	.nn	.int	
trespass	.vb/.nn	.hi	
trial	.nn	.elem	
triangle	.nn	.elem	
tribal	.aj	.hi	
tribe	.nn	.int	
tribunal	.nn	.hi	
tribute	.nn	.hi	
trick	.nn/.vb	.elem	
tricky	.aj	.int	
trifle	.nn/.vb	.hi	
trigger	.nn/.vb	.hi	
trillion	.nn	.hi	
trim	.aj/.vb/.nn	.hi	
trio	.nn	.hi	
trip	.nn	.elem	
triple	.aj/.vb	.hi	
triumph	.nn/.vb	.int	
triumphant	.aj	.hi	
trivial	.aj	.hi	
trolley	.nn	.hi	= tram, tramcar, streetcar
troop	.nn/.vb	.int	
trophy	.nn	.hi	
tropic	.nn/.aj	.hi	
tropical	.aj	.int	
trot	.vb/.nn	.hi	
trouble	.nn/.vb	.elem	
troubled	.aj	.hi	
troublesome	.aj	.int	
trousers	.nn	.elem	= pants (American English)
trout	.nn	.hi	
truant	.nn/.aj/.vb	.hi	
truce	.nn	.hi	
truck	.nn	.elem	
true	.aj	.elem	
truly	.av	.hi	
trumpet	.nn	.elem	
trunk	.nn	.int	
trust	.nn/.vb	.elem	
trustee	.nn	.hi	
truth	.nn	.elem	
truthful	.aj	.int	
try	.vb/.nn	.elem	
T-shirt	.nn	.elem	= tee-shirt
tub	.nn	.elem	
tube	.nn	.int	= underground railway
tuberculosis	.nn	.hi	= TB
tuck	.vb/.nn	.hi	
Tuesday	.nn	.elem	= Tues./Tue.
tug	.vb/.nn	.int	
tug-of-war	.nn	.hi	
tuition	.nn	.hi	
tulip	.nn	.int	
tumble	.vb/.nn	.int	
tummy	.nn	.elem	= stomach
tumor	.nn	.hi	= tumour (British English)
tuna	.nn	.hi	
tune	.nn/.vb	.int	
tunnel	.nn	.elem	
turbine	.nn	.hi	
turbulent	.aj	.hi	
turkey	.nn	.elem	
turmoil	.nn	.hi	
turn	.vb/.nn	.elem	
turnover	.nn	.hi	
turtle	.nn	.elem	
tutor	.nn/.vb	.int	
TV	.nn	.elem	= television
twelve	.nu/.pn/.nn/.aj	.elem	
twenty	.nu/.pn/.nn/.aj	.elem	
twice	.av	.elem	
twig	.vb	.hi	明白
twig	.nn	.int	細枝
twilight	.nn	.hi	
twin	.nn/.aj/.vb	.int	
twinkle	.vb/.nn	.int	
twist	.vb/.aj	.int	
two	.nu/.pn/.nn/.aj	.elem	
two-thirds	.nn/.pn/.aj/.av	.hi	= two thirds
type 	.vb	.elem	打字
type 	.nn	.elem	種類,型
typewriter	.nn	.int	
typhoon	.nn	.elem	
typical	.aj	.int	
typically	.av	.hi	
typing	.nn 	.int	
typist	.nn	.int	
tyranny	.nn	.hi	
tyrant	.nn	.hi	
ugly	.aj	.elem	
ulcer	.nn	.hi	
ultimate	.aj/.nn	.hi	
ultimately	.av	.hi	
ultraviolet	.aj	.hi	
umbrella	.nn	.elem	
umpire	.nn/.vb	.hi	
unable	.aj	.int	
unacceptable	.aj	.hi	
unanimous	.aj	.hi	
unaware	.aj	.int	
unbeaten	.aj	.hi	
unbelievable	.aj	.int	
uncertain	.aj	.hi	
uncertainty	.nn	.hi	
unchanged	.aj	.hi	
uncle	.nn	.elem	
unclear	.aj	.hi	
uncomfortable	.aj	.hi	
unconditional	.aj	.hi	
unconscious	.aj	.int	
uncover	.vb	.hi	
under	.pr/.av	.elem	
underestimate	.vb	.hi	
undergo	.vb	.hi	
undergraduate	.nn	.hi	
underground	.aj/.av/.nn	.int	
underlie	.vb	.hi	
underline	.vb	.elem	
underlying	.aj	.hi	
undermine	.vb	.hi	
underneath	.pr/.av/.aj/.nn	.hi	
underpass	.nn	.elem	
understand	.vb	.elem	
understandable	.aj	.hi	
understanding	.nn/.aj	.int	
undertake	.vb	.int	
underwater	.av/.aj	.int	
underway	.aj	.hi	
underwear	.nn	.elem	
underweight	.aj	.int	
underwrite	.vb	.hi	
undo	.vb	.hi	
undoubted	.aj	.hi	
undoubtedly	.av	.hi	
uneasy	.aj	.hi	
unemployed	.aj/.nn	.hi	
unemployment	.nn	.hi	
unexpected	.aj	.int	
unfair	.aj	.hi	
unfit	.aj	.hi	
unfold	.vb	.hi	
unfortunate	.aj	.int	
unfortunately	.av	.int	
unfriendly	.aj	.int	
unhappy	.aj	.elem	
unidentified	.aj	.hi	
unification	.nn	.hi	
uniform	.nn/.aj	.elem	
unify	.vb	.hi	
union	.nn	.int	
unique	.aj	.elem	
unit	.nn	.elem	
unite	.vb	.int	
united	.aj	.int	
unity	.nn	.int	
universal	.aj/.nn	.int	
universe	.nn	.elem	
university	.nn	.elem	
unknown	.aj	.int	
unleash	.vb	.hi	
unless	.cj	.int	
unlike	.pr	.int	
unlikely	.aj	.int	
unload	.vb	.hi	
unlock	.vb	.hi	
unnecessary	.aj	.hi	
unofficial	.aj	.hi	
unpack	.vb	.hi	
unpleasant	.aj	.hi	
unpopular	.aj	.hi	
unprecedented	.aj	.hi	
unpredictable	.aj	.hi	
unrest	.nn	.hi	
unsuccessful	.aj	.hi	
until	.cj/.pr	.elem	= till
untouched	.aj	.int	
unusual	.aj	.int	
unusually	.av	.hi	
unveil	.vb	.hi	
unwanted	.aj	.hi	
unwilling	.aj	.hi	
up	.vb	.hi	增加；起身離開
up 	.av/.pr/.aj	.elem	上,沿著,完,起床
upbringing	.nn	.hi	
update	.vb/.nn	.hi	
upgrade	.vb/.nn	.hi	
uphold	.vb	.hi	
upload	.vb	.hi	
upon	.pr	.elem	
upper	.aj/.nn	.elem	
upright	.aj/.nn	.hi	
uprising	.nn	.hi	
upset	.aj/.nn/.vb	.int	
upstairs	.av/.aj/.nn	.elem	
up-to-date	.aj	.hi	= up to date
upward 	.aj	.int	
uranium	.nn	.hi	
urban	.aj	.int	
urge	.vb/.nn	.int	
urgency	.nn	.hi	
urgent	.aj	.int	
urine	.nn	.hi	
us	.pn	.elem	
USA	.nn	.elem	= United States (of America) 
usage	.nn	.int	
use	.vb/.nn	.elem	(P)
used 	.aj	.elem	用過的 
used 	.vb	.elem	習慣於
useful	.aj	.elem	
useless	.aj	.int	
user	.nn	.elem	
usher	.nn/.vb	.hi	
usual	.aj	.elem	
usually	.av	.elem	
utensil	.nn	.hi	
utility	.nn/.aj	.hi	
utilize	.vb	.hi	
utmost	.aj/.nn	.hi	
utter	.vb/.aj	.hi	
utterly	.av	.hi	
vacancy	.nn	.hi	
vacant	.aj	.int	
vacation	.nn/.vb	.elem	
vaccine	.nn	.hi	
vacuum	.nn/.vb	.hi	
vague	.aj	.int	
vain	.aj	.int	
Valentine's Day	.nn	.elem	
valiant	.aj	.hi	
valid	.aj	.hi	
validity	.nn	.hi	
valley	.nn	.elem	
valuable	.aj	.int	
value	.nn/.vb	.elem	
valve	.nn	.hi	
van	.nn	.int	
vanilla	.nn	.hi	
vanish	.vb	.int	
vanity	.nn	.hi	
vapor	.nn	.int	= vapour (British English)
variable	.aj/.nn	.hi	
variation	.nn	.hi	
varied	.aj	.hi	
variety	.nn	.int	
various	.aj	.int	
vary	.vb	.int	
vase	.nn	.int	
vast	.aj	.int	
VCR	.nn	.elem	= video cassette recorder
vegetable	.nn/.aj	.elem	
vegetarian	.aj/.nn	.int	
vegetation	.nn	.hi	
vehicle	.nn	.int	
veil	.nn/.vb	.hi	
vein	.nn	.hi	
velocity	.nn	.hi	
velvet	.nn	.hi	
vend	.vb	.hi	
vendor	.nn	.elem	
vent	.nn/.vb	.hi	
ventilate	.vb	.hi	
venture	.nn/.vb	.int	
venue	.nn	.hi	
.vb	.nn	.int	
.vbal	.aj	.hi	
verdict	.nn	.hi	
verge	.nn/.vb	.hi	
verify	.vb	.hi	
versatile	.aj	.hi	
verse	.nn	.int	
version	.nn	.int	
versus	.pr	.hi	= vs.
vertical	.aj/.nn	.hi	
very 	.av	.elem	非常,很
very 	.aj	.elem	加強語氣
vessel	.nn	.int	
vest	.nn	.elem	
veteran	.nn	.hi	
veterinarian	.nn	.hi	= vet
veto	.vb/.nn	.hi	
via	.pr	.hi	
viable	.aj	.hi	
vibrate	.vb	.hi	
vibration	.nn	.hi	
vicar	.nn	.hi	
vice	.nn	.hi	
vice-president	.nn	.hi	
vicinity	.nn	.hi	
vicious	.aj	.hi	
victim	.nn	.int	
victimize	.vb	.hi	
victor	.nn	.hi	
victorious	.aj	.hi	
victory	.nn	.elem	
video	.nn/.vb	.elem	
videotape	.nn/.vb	.int	
view	.nn/.vb	.elem	
viewer	.nn	.hi	
viewpoint	.nn	.hi	
vigor	.nn	.int	= vigour (British English)
vigorous	.aj	.int	
villa	.nn	.hi	
village	.nn	.elem	
villager	.nn	.hi	
villain	.nn	.hi	
vine	.nn	.hi	
vinegar	.nn	.elem	
vineyard	.nn	.hi	
vintage	.nn/.aj	.hi	
vinyl	.nn	.hi	
violate	.vb	.int	
violation	.nn	.int	
violence	.nn	.int	
violent	.aj	.int	
violet	.nn/.aj	.int	
violin	.nn	.elem	
violinist	.nn	.int	
virgin	.nn/.aj	.int	
virtual	.aj	.hi	
virtually	.av	.hi	
virtue	.nn	.int	
virus	.nn	.int	
visa	.nn	.hi	
visible	.aj	.int	
vision	.nn	.int	
visit	.vb/.nn	.elem	
visitor	.nn	.elem	
visual	.aj	.int	
visualize	.vb	.hi	
vital	.aj	.int	
vitality	.nn	.hi	
vitamin	.nn	.int	
vivid	.aj	.int	
vocabulary	.nn	.elem	
vocal	.aj	.hi	
vocals	.nn	.hi	
vocation	.nn	.hi	
vocational	.aj	.hi	
vogue	.nn	.hi	
voice	.nn	.elem	
void	.nn/.aj/.vb	.hi	
volatile	.aj	.hi	
volcano	.nn	.int	
volleyball	.nn	.elem	
volt	.nn	.hi	
voltage	.nn	.hi	
volume	.nn	.elem	= vol.
voluntary	.aj	.int	
volunteer	.nn/.vb	.int	
vomit	.vb/.nn	.hi	
vote	.nn/.vb	.elem	
voter	.nn	.elem	
voucher	.nn	.hi	
vow	.vb/.nn	.hi	
vowel	.nn	.int	
voyage	.nn/.vb	.int	
vulgar	.aj	.hi	
vulnerable	.aj	.hi	
wade	.vb/.nn	.hi	
wag	.vb/.nn	.hi	
wage	.nn/.vb	.int	
wagon	.nn	.int	
wail	.nn/.vb	.hi	
waist	.nn	.elem	
wait	.vb	.elem	
waiter	.nn	.elem	
waitress	.nn	.elem	
wake	.vb	.elem	
waken	.vb	.int	
walk	.vb/.nn	.elem	
walkman	.nn	.elem	
wall	.nn	.elem	
wallet	.nn	.elem	
wallpaper	.nn/.vb	.hi	
walnut	.nn	.hi	
waltz	.nn/.vb	.int	
wander	.vb/.nn	.int	
want	.vb	.elem	
war	.nn	.elem	
ward	.nn/.vb	.int	
wardrobe	.nn	.hi	
ware	.nn	.hi	
warehouse	.nn/.vb	.hi	
warfare	.nn	.int	
warm	.aj/.vb	.elem	
warmth	.nn	.int	
warn	.vb	.int	
warning	.nn/.aj	.int	
warrant	.vb/.nn	.hi	
warranty	.nn	.hi	
warring	.aj	.hi	
warrior	.nn	.hi	
warship	.nn	.int	
w.arime	.nn	.hi	
wary	.aj	.hi	
wash	.vb	.elem	
washing	.nn	.int	
waste	.nn/.vb	.elem	
watch 	.nn	.elem	手錶
watch 	.vb	.elem	觀看,注視
watchman	.nn	.int	
water	.nn/.vb	.elem	
waterfall	.nn	.elem	
watermelon	.nn	.elem	
waterproof	.aj/.nn/.vb	.int	
watertight	.aj	.hi	
watt	.nn	.hi	
wave	.nn/.vb	.elem	波浪,波動,揮手
wax	.nn/.vb	.int	
way	.av	.int	加強語氣
way 	.nn	.elem	路,方式,方法
way-out	.aj	.hi	
we	.pn	.elem	
weak	.aj	.elem	
weaken	.vb	.int	
weakness	.nn	.hi	
wealth	.nn	.int	
wealthy	.aj	.int	
weapon	.nn	.elem	
wear	.vb/.nn	.elem	
weary	.aj/.vb	.hi	
weather	.nn	.elem	
weave	.vb/.nn	.int	
web	.nn	.int	
website	.nn	.hi	
wed	.vb	.hi	
wedding	.nn	.elem	
wedge	.vb/.nn	.hi	
Wednesday	.nn	.elem	= Wed., Weds.
wee	.aj/.vb/.nn	.hi	
weed	.nn/.vb	.int	
week	.nn	.elem	
weekday	.nn	.elem	
weekend	.nn	.elem	
weekly	.aj/.av/.nn	.elem	
weep	.vb/.nn	.int	
weigh	.vb	.int	
weight	.nn	.elem	
weird	.aj	.hi	
welcome	.vb/.aj/.nn	.elem	
weld	.vb/.nn	.hi	
welfare	.nn/.aj	.int	
well	.nn	.int	井
well 	.av/.aj	.elem	良好地,健康的
well-being	.nn	.hi	
well-known	.aj	.int	
west	.nn/.av/.aj	.elem	
western	.aj/.nn	.elem	
westerner	.nn	.int	
wet	.aj/.vb	.elem	
whale	.nn	.elem	
wharf	.nn	.hi	
what	.pn/.aj	.elem	
whatever	.pn/.aj	.elem	
whatsoever	.av	.hi	
wheat	.nn	.int	
wheel	.nn	.elem	
wheelchair	.nn	.hi	
when	.cj/.av/.pn	.elem	
whenever	.av/.cj	.int	
where	.av/.cj	.elem	
whereabouts	.av/.nn	.hi	
whereas	.cj	.hi	
whereby	.av	.hi	
wherever	.av/.cj	.int	
whether	.cj	.elem	
which	.pn/.cj/.aj	.elem	
whichever	det./.pn 	.int	
while 	.cj	.elem	當…時候,然而
while 	.nn	.elem	一段時間
whilst	.cj	.hi	
whine	.nn/.vb	.hi	
whip	.nn/.vb	.int	
whirl	.vb/.nn	.hi	
whisk	.vb/.nn	.hi	
whiskey	.nn	.hi	= whisky
whisper	.vb/.nn	.int	
whistle	.vb/.nn	.int	
white	.aj/.nn	.elem	
who	.pn/.cj	.elem	
whoever	.pn/.cj	.int	= whomever
whole	.aj/.nn	.elem	
wholesale	.nn/.av/.aj/.vb	.hi	
wholesome	.aj	.hi	
wholly	.av	.hi	
whom	.pn/.cj	.elem	
whose	.de/.cj	.elem	
why	.av/.cj	.elem	
wicked	.aj	.int	
wide	.aj	.elem	
widen	.vb	.elem	
widespread	.aj	.int	
widow	.nn/.vb	.hi	女性為widow，男性為widower
width	.nn	.elem	
wife	.nn	.elem	
wig	.nn	.hi	
wild	.aj/.nn	.elem	
wilderness	.nn	.int	
wildlife	.nn	.int	
wildly	.av	.int	
will	.nn	.int	意志
will 	aux.	.elem	助動詞
willing	.aj	.elem	
willow	.nn	.int	
win	.vb/.nn	.elem	
wind 	.nn	.elem	風 
window	.nn	.elem	
windshield	.nn	.hi	
windy	.aj	.elem	
wine	.nn	.elem	
wing	.nn	.elem	
winger	.nn	.hi	
wink	.vb/.nn	.int	
winner	.nn	.elem	
winning	.aj/.nn	.hi	
winter	.nn	.elem	
wipe	.vb/.nn	.int	
wire	.nn/.vb	.int	
wisdom	.nn	.int	
wise	.aj	.elem	
wish	.vb/.nn	.elem	
wit	.nn	.int	
witch	.nn	.int	
with	.pr	.elem	
withdraw	.vb	.int	
withdrawal	.nn	.hi	
wither	.vb	.hi	
withhold	.vb	.hi	
within	.pr/.av	.elem	
without	.pr	.elem	
withstand	.vb	.hi	
witness	.nn/.vb	.int	
witty	.aj	.hi	
wizard	.nn	.int	
woe	.nn	.hi	
wok	.nn	.elem	
wolf	.nn	.elem	
woman	.nn	.elem	
wonder	.vb/.nn	.elem	
wonderful	.aj	.elem	
woo	.vb	.hi	
wood	.nn	.elem	
wooden	.aj	.elem	
woodland	.nn	.hi	
woodpecker	.nn	.hi	
wool	.nn	.int	
word	.nn	.elem	
work	.nn/.vb	.elem	
workbook	.nn	.int	
worker	.nn	.elem	
workforce	.nn	.hi	
working	.aj/.nn	.int	
workman	.nn	.hi	
workplace	.nn	.hi	
workshop	.nn	.int	
world	.nn/.aj	.elem	
worldwide	.av/.aj	.int	
worm	.nn/.vb	.int	
worn	.aj	.int	
worried	.aj	.int	
worry	.vb/.nn	.elem	
worrying	.aj	.hi	
worse	.aj/.av	.int	
worsen	.vb	.hi	
worship	.vb/.nn	.hi	
worth	.pr/.nn	.elem	
worthless	.aj	.int	
worthwhile	.aj	.int	
worthy	.aj/.nn	.int	
would	aux.	.elem	
would-be	.aj	.hi	
wound	.nn/.vb	.elem	
wow	.in/.vb	.int	
wrap	.vb/.nn	.int	
wrapping	.nn	.int	
wreath	.nn	.hi	
wreck	.vb/.nn	.int	
wrench	.vb/.nn	.hi	
wrestle	.nn/.vb	.hi	
wretched	.aj	.hi	
wring	.vb/.nn	.hi	
wrinkle	.nn/.vb	.int	
wrist	.nn	.elem	
write	.vb	.elem	
writer	.nn	.elem	
writing	.nn	.int	
written	.aj	.hi	
wrong	.aj/.av/.nn	.elem	
Xerox	.nn/.vb	.hi	= xerox
X-ray	.nn/.vb	.int	
yacht	.nn	.hi	
yam	.nn	.int	= sweet potato (American English)
yard	.nn	.elem	
yarn	.nn/.vb	.hi	
yawn	.vb/.nn	.int	
yeah	.in/.av	.elem	= yes
year	.nn	.elem	
yearly	.aj/.av	.elem	
yearn	.vb	.hi	
yeast	.nn	.hi	
yell	.vb/.nn	.int	
yellow	.aj/.nn	.elem	
yen	.nn	.hi	渴望，日本貨幣單位￥
yen	.vb	.hi	渴望
yes	.in/.av	.elem	= yeah
yesterday	.av/.nn	.elem	
yet	.av/.cj	.elem	
yield	.vb/.nn	.hi	
yoga	.nn	.hi	
yogurt	.nn	.int	= yoghurt
yoke	.nn/.vb	.hi	
yolk	.nn	.int	
you	.pn	.elem	
young	.aj/.nn	.elem	
youngster	.nn	.int	
your	.de	.elem	
yours	.pn	.elem	
yourself	.pn	.elem	
youth	.nn	.elem	
youthful	.aj	.int	
yucky	.aj	.hi	
yummy	.aj	.elem	
zeal	.nn	.hi	
zebra	.nn	.elem	
zero	.nu/.nn/.aj	.elem	
zinc	.nn	.hi	
zip	.nn/.vb	.hi	= ZIP/zone improvement plan/zip code
zipper	.nn/.vb	.hi	
zone	.nn/.vb	.int	
zoo	.nn	.elem	
zoom	.vb/.nn	.hi	